DBN,Cohort Year,# Total Cohort,# Grads,# Total Regents,# Advanced Regents,# Dropout,# Asian,# Black,# Hispanic,# White,# Native American,# Multi-Racial,# Female,# Male,# Econ Disadv,# Not Econ Disadv,# SWD,# Not SWD
01M292,2017,65,59,59,8,0,6,17,39,1,1,1,35,30,51,14,20,45
01M292,2016,31,29,29,9,1,7,11,9,3,0,1,16,15,26,5,7,24
01M292,2015,28,25,22,2,3,3,6,18,1,0,0,10,18,23,5,8,20
01M292,2014,29,25,22,0,1,3,6,19,1,0,0,6,23,27,2,8,21
01M292,2013,36,24,23,0,7,9,6,19,2,0,0,21,15,33,3,12,24
01M292,2012,44,23,19,1,10,5,7,28,3,0,1,15,29,39,5,13,31
01M292,2011,73,46,41,0,7,10,24,35,0,2,2,23,50,61,12,20,53
01M292,2010,61,24,24,1,17,10,11,38,0,1,1,34,27,49,12,14,47
01M292,2009,85,47,42,0,8,9,25,49,2,0,0,28,57,75,10,16,69
01M292,2008,70,35,29,0,13,9,23,37,1,0,0,33,37,44,26,14,56
01M292,2007,77,41,28,0,5,7,18,50,2,0,0,30,47,68,9,21,56
01M292,2006,78,43,36,0,11,9,24,42,2,0,1,34,44,51,27,18,60
01M292,2005,64,43,27,0,9,8,21,31,4,0,0,25,39,48,16,15,49
01M292,2004,55,37,17,0,3,10,23,20,1,1,0,28,27,54,1,9,46
01M448,2017,134,132,132,71,2,39,23,62,7,1,2,52,82,120,14,23,111
01M448,2016,128,123,123,73,5,44,25,55,3,1,0,55,73,112,16,22,106
01M448,2015,99,92,79,18,4,32,27,36,4,0,0,48,51,84,15,15,84
01M448,2014,88,82,73,20,3,23,19,42,2,1,1,38,50,77,11,13,75
01M448,2013,78,70,64,20,7,25,19,31,2,1,0,30,48,72,6,17,61
01M448,2012,66,50,46,11,14,19,18,25,3,1,0,28,38,57,9,17,49
01M448,2011,82,68,58,13,8,46,9,25,2,0,0,27,55,74,8,18,64
01M448,2010,71,56,46,3,11,16,18,35,2,0,0,34,37,63,8,15,56
01M448,2009,88,65,50,6,9,16,28,41,3,0,0,39,49,73,15,24,64
01M448,2008,120,80,75,10,9,25,34,57,4,0,0,56,64,94,26,20,100
01M448,2007,150,99,77,17,17,35,32,73,10,0,0,62,88,112,38,42,108
01M448,2006,124,53,42,8,20,21,26,64,6,1,6,65,59,88,36,25,99
01M448,2005,121,64,35,4,11,23,19,64,5,0,10,59,62,85,36,22,99
01M448,2004,112,75,36,6,4,42,16,49,2,1,2,68,44,82,30,19,93
01M448,2003,87,67,39,11,11,30,8,44,5,0,0,45,42,83,4,8,79
01M448,2002,52,33,19,8,1,20,5,24,3,0,0,29,23,51,1,5,47
01M448,2001,64,46,32,7,6,23,4,30,6,1,0,27,37,63,1,7,57
01M450,2017,79,73,73,0,0,9,13,48,7,2,0,37,42,55,24,14,65
01M450,2016,89,86,86,0,0,11,20,46,12,0,0,45,44,60,29,24,65
01M450,2015,93,82,82,0,1,20,19,43,8,1,2,45,48,69,24,19,74
01M450,2014,92,88,88,0,1,7,19,52,10,0,4,40,52,62,30,16,76
01M450,2013,89,80,80,0,3,8,19,53,7,2,0,45,44,60,29,22,67
01M450,2012,90,72,71,0,4,10,20,55,5,0,0,44,46,72,18,23,67
01M450,2011,88,75,74,0,3,11,20,49,7,1,0,40,48,67,21,19,69
01M450,2010,90,70,70,0,3,13,21,47,8,1,0,53,37,75,15,21,69
01M450,2009,78,56,56,0,2,9,15,47,7,0,0,39,39,62,16,13,65
01M450,2008,88,61,60,0,11,10,24,41,13,0,0,29,59,63,25,25,63
01M450,2007,89,56,56,0,7,2,28,53,6,0,0,51,38,63,26,20,69
01M450,2006,90,70,67,0,5,8,25,52,4,1,0,41,49,72,18,20,70
01M450,2005,85,61,58,0,9,5,23,52,4,0,1,47,38,69,16,20,65
01M450,2004,80,58,48,0,9,5,19,46,8,2,0,45,35,55,25,19,61
01M450,2003,79,49,44,0,10,3,26,45,5,0,0,34,45,68,11,23,56
01M450,2002,72,45,45,0,7,4,26,38,4,0,0,33,39,67,5,19,53
01M450,2001,61,41,40,0,12,2,20,38,0,1,0,33,28,58,3,12,49
01M458,2017,55,20,17,0,2,2,20,32,0,1,0,24,31,52,3,23,32
01M458,2016,67,24,16,0,2,5,24,34,2,2,0,32,35,58,9,26,41
01M458,2015,79,17,13,0,7,2,34,39,4,0,0,39,40,67,12,24,55
01M458,2014,73,25,24,0,12,1,25,41,5,0,1,47,26,65,8,17,56
01M458,2013,94,14,12,0,12,1,34,47,0,0,0,53,41,73,21,23,71
01M458,2012,82,12,12,0,9,2,40,44,1,0,0,54,28,64,18,16,66
01M458,2011,87,13,11,0,9,4,34,54,3,0,0,47,40,66,21,18,69
01M458,2010,95,8,8,0,24,7,41,64,3,0,0,54,41,80,15,13,82
01M458,2009,115,8,8,0,40,2,34,61,3,6,0,58,57,91,24,15,100
01M458,2008,102,6,5,0,47,0,33,59,2,0,0,53,49,82,20,12,90
01M458,2007,106,6,5,0,37,0,29,67,5,1,0,64,42,86,20,11,95
01M509,2017,6,3,3,0,3,1,1,3,0,0,1,4,2,5,1,0,6
01M509,2016,25,18,17,1,2,1,6,17,1,0,0,18,7,22,3,5,20
01M509,2015,38,33,25,1,2,1,20,17,0,0,0,28,10,31,7,6,32
01M509,2014,42,27,13,1,8,2,12,27,1,0,0,20,22,41,1,17,25
01M509,2013,59,39,28,2,4,1,28,28,2,0,0,39,20,49,10,18,41
01M509,2012,74,43,42,8,8,6,30,36,1,1,0,43,31,61,13,19,55
01M509,2011,102,45,38,5,18,8,44,47,2,1,0,54,48,88,14,34,68
01M509,2010,59,26,25,2,9,5,22,30,1,1,0,31,28,53,6,13,46
01M509,2009,72,25,21,4,10,13,16,41,2,0,0,42,30,64,8,14,58
01M509,2008,82,44,41,16,14,7,19,55,1,0,0,41,41,72,10,20,62
01M509,2007,95,47,34,8,15,6,15,73,1,0,0,36,59,75,20,16,79
01M509,2006,84,47,40,17,5,17,11,54,2,0,0,45,39,73,11,13,71
01M509,2005,88,49,38,18,14,10,15,63,0,0,0,38,50,79,9,17,71
01M509,2004,65,29,13,3,8,7,9,49,0,0,0,32,33,64,1,16,49
01M509,2003,70,31,22,0,18,7,7,54,2,0,0,41,29,62,8,10,60
01M509,2002,55,22,11,4,11,10,9,36,0,0,0,31,24,34,21,10,45
01M509,2001,69,34,6,0,10,10,9,48,2,0,0,31,38,53,16,13,56
01M515,2017,158,56,56,14,25,67,18,70,2,1,0,62,96,121,37,17,141
01M515,2016,284,115,111,47,59,140,25,113,5,1,0,123,161,219,65,27,257
01M515,2015,241,106,101,46,51,141,29,64,7,0,0,109,132,154,87,9,232
01M515,2014,226,84,83,37,55,118,34,66,4,4,0,104,122,128,98,14,212
01M515,2013,232,83,82,43,64,134,23,69,4,2,0,109,123,75,157,15,217
01M515,2012,248,84,84,53,77,162,24,55,2,1,4,114,134,101,147,12,236
01M515,2011,264,105,103,57,75,177,31,51,3,1,1,108,156,145,119,13,251
01M515,2010,293,83,81,56,109,238,14,35,2,1,3,148,145,241,52,5,288
01M515,2009,223,70,70,47,97,171,12,35,2,2,1,113,110,223,0,2,221
01M515,2008,183,80,79,56,50,144,16,17,4,0,2,80,103,183,0,7,176
01M515,2007,129,68,61,40,33,120,4,3,2,0,0,57,72,127,2,0,129
01M515,2006,193,105,91,69,35,180,7,6,0,0,0,101,92,193,0,1,192
01M515,2005,154,70,56,45,20,142,5,5,2,0,0,73,81,154,0,1,153
01M515,2004,200,97,74,60,25,191,4,5,0,0,0,101,99,197,3,1,199
01M515,2003,205,86,71,48,39,183,9,13,0,0,0,89,116,173,32,4,201
01M515,2002,172,77,53,0,28,154,11,6,1,0,0,90,82,98,74,1,171
01M515,2001,166,88,36,0,30,152,5,8,1,0,0,84,82,104,62,1,165
01M539,2017,131,129,127,99,1,33,15,29,49,1,4,56,75,63,68,22,109
01M539,2016,158,150,145,118,2,47,30,26,53,1,1,74,84,66,92,23,135
01M539,2015,140,140,137,112,0,48,11,19,58,2,2,64,76,72,68,17,123
01M539,2014,131,122,120,100,2,45,14,28,39,0,5,65,66,62,69,6,125
01M539,2013,183,170,170,145,0,76,22,32,50,1,2,97,86,102,81,9,174
01M539,2012,186,185,184,155,0,69,26,33,55,2,1,92,94,99,87,7,179
01M539,2011,122,119,119,91,1,55,17,18,31,0,1,64,58,60,62,3,119
01M539,2010,113,107,106,65,2,29,14,25,43,2,0,48,65,56,57,7,106
01M539,2009,137,133,133,96,0,51,32,30,23,1,0,64,73,93,44,2,135
01M539,2008,161,155,155,102,0,34,34,49,44,0,0,81,80,93,68,2,159
01M539,2007,128,122,122,88,3,25,19,32,51,1,0,59,69,75,53,3,125
01M539,2006,46,46,46,31,0,13,3,7,23,0,0,22,24,21,25,2,44
01M539,2005,49,47,47,38,0,7,8,10,24,0,0,26,23,10,39,3,46
01M539,2004,60,58,58,54,2,25,6,12,17,0,0,29,31,23,37,4,56
01M539,2003,58,58,57,49,0,19,7,19,13,0,0,24,34,33,25,0,58
01M539,2002,7,7,7,6,0,2,1,3,1,0,0,4,3,7,0,0,7
01M539,2001,17,16,16,12,1,6,3,7,1,0,0,12,5,14,3,0,17
01M650,2017,64,19,19,0,8,1,24,39,0,0,0,26,38,57,7,24,40
01M650,2016,99,35,29,0,9,3,35,58,1,1,1,55,44,87,12,31,68
01M650,2015,101,33,24,0,30,3,46,51,0,1,0,49,52,84,17,24,77
01M650,2014,103,29,26,0,22,3,50,48,1,1,0,60,43,89,14,10,93
01M650,2013,110,26,22,1,16,3,41,60,3,1,2,65,45,85,25,18,92
01M650,2012,112,32,32,0,18,5,25,71,10,1,0,77,35,84,28,9,103
01M650,2011,109,29,29,0,14,5,34,64,4,2,0,69,40,85,24,5,104
01M650,2010,136,43,40,0,17,2,53,73,7,1,0,85,51,109,27,8,128
01M650,2009,130,49,48,0,15,4,54,68,2,0,2,77,53,107,23,10,120
01M650,2008,122,38,38,0,15,1,52,62,5,1,1,75,47,100,22,5,117
01M650,2007,118,45,29,0,18,4,49,59,6,0,0,67,51,101,17,8,110
01M650,2006,89,49,36,0,6,4,32,49,3,0,1,55,34,75,14,2,87
01M650,2005,95,31,17,0,7,6,39,45,5,0,0,66,29,78,17,8,87
01M650,2004,67,28,10,0,7,1,24,38,4,0,0,46,21,55,12,5,62
01M650,2003,93,27,7,0,4,4,34,51,4,0,0,55,38,70,23,8,85
01M650,2002,92,22,6,0,8,4,31,54,2,1,0,49,43,59,33,2,90
01M650,2001,86,27,2,0,11,9,21,53,3,0,0,45,41,53,33,5,81
01M696,2017,161,151,151,1,0,46,14,28,69,0,4,99,62,71,90,14,147
01M696,2016,123,118,118,0,0,36,13,26,45,0,3,87,36,51,72,8,115
01M696,2015,150,145,145,0,0,55,18,18,55,0,4,90,60,76,74,2,148
01M696,2014,135,132,132,0,0,25,30,19,59,0,2,86,49,62,73,3,132
01M696,2013,113,107,107,0,0,23,18,25,45,0,2,65,48,45,68,1,112
01M696,2012,131,127,127,0,0,19,20,23,65,0,4,66,65,43,88,1,130
01M696,2011,154,148,148,0,2,25,24,33,70,0,2,103,51,49,105,1,153
01M696,2010,143,142,142,0,0,23,16,19,83,0,2,102,41,27,116,1,142
01M696,2009,123,116,116,0,0,15,22,17,68,0,1,86,37,32,91,1,122
01M696,2008,146,138,138,0,1,25,22,32,63,2,2,101,45,39,107,3,143
01M696,2007,125,122,122,0,1,18,18,15,74,0,0,80,45,20,105,0,125
01M696,2006,139,134,134,0,1,17,27,18,76,0,1,93,46,26,113,0,139
01M696,2005,115,107,107,0,1,13,23,24,37,0,18,80,35,32,83,0,115
01M696,2004,117,108,108,0,1,17,40,21,38,0,1,90,27,31,86,0,117
01M696,2003,126,123,123,0,1,16,16,20,58,0,16,94,32,34,92,0,126
01M696,2002,110,104,103,0,0,15,29,19,47,0,0,84,26,42,68,0,110
01M696,2001,119,112,110,0,2,17,37,12,52,1,0,75,44,44,75,0,119
02M047,2017,31,29,29,20,1,2,18,23,4,0,1,21,10,29,2,12,19
02M047,2016,48,48,43,15,0,1,13,37,7,0,0,37,11,40,8,12,36
02M047,2015,40,37,29,6,3,1,5,20,2,0,1,29,11,36,4,10,30
02M047,2014,35,30,27,7,2,1,13,25,2,0,0,28,7,30,5,9,26
02M047,2013,35,32,28,4,1,1,13,28,2,0,0,21,14,31,4,6,29
02M047,2012,58,48,43,8,1,1,9,10,3,0,0,32,26,45,13,14,44
02M047,2011,29,15,13,2,1,1,6,16,2,0,0,20,9,25,4,13,16
02M047,2010,41,29,20,0,3,1,3,10,0,0,0,24,17,34,7,19,22
02M047,2009,44,29,26,3,2,1,1,15,0,0,0,25,19,40,4,20,24
02M047,2008,36,15,14,0,4,4,4,7,3,0,0,19,17,30,6,13,23
02M047,2007,23,16,12,1,1,2,2,7,0,0,0,15,8,14,9,3,20
02M047,2006,25,19,8,0,1,0,4,27,0,0,0,20,5,21,4,7,18
02M047,2005,24,9,4,0,3,0,13,27,0,0,0,15,9,20,4,9,15
02M047,2004,14,5,5,2,0,0,9,23,1,0,2,12,2,8,6,7,7
02M047,2003,17,5,4,0,1,0,12,23,0,0,0,8,9,13,4,9,8
02M047,2002,18,4,1,0,1,0,10,22,4,0,0,9,9,13,5,13,5
02M047,2001,11,0,0,0,1,0,12,9,2,1,0,3,8,11,0,11,0
02M135,2017,55,50,50,28,4,4,17,33,1,0,0,19,36,44,11,13,42
02M135,2016,62,57,57,1,3,1,17,40,2,1,1,29,33,50,12,15,47
02M135,2015,62,54,53,4,5,2,20,36,3,1,0,35,27,50,12,10,52
02M135,2014,75,56,51,0,7,7,21,44,1,0,2,37,38,53,22,18,57
02M135,2013,91,61,60,0,5,5,23,59,4,0,0,54,37,56,35,14,77
02M139,2017,104,91,91,0,7,4,24,69,4,2,1,37,67,92,12,22,82
02M139,2016,97,81,81,10,8,1,31,57,6,1,1,37,60,72,25,23,74
02M139,2015,80,70,60,4,6,1,27,49,2,0,1,33,47,63,17,22,58
02M139,2014,100,78,69,2,11,3,24,67,6,0,0,23,77,84,16,27,73
02M139,2013,75,62,50,3,6,4,17,40,11,1,2,23,52,61,14,26,49
02M260,2017,124,121,121,0,0,13,5,13,83,2,8,92,32,20,104,20,104
02M260,2016,98,95,95,0,0,8,2,21,65,0,2,66,32,19,79,18,80
02M260,2015,86,78,77,0,1,14,8,14,47,1,2,56,30,23,63,13,73
02M280,2017,101,93,93,0,1,4,38,51,4,1,3,57,44,73,28,15,86
02M280,2016,89,77,77,0,1,8,32,40,7,1,1,53,36,61,28,18,71
02M280,2015,80,77,71,0,2,7,29,33,4,2,5,41,39,49,31,15,65
02M280,2014,84,81,74,0,2,4,28,37,14,0,1,44,40,64,20,17,67
02M282,2017,104,96,96,0,2,8,25,56,8,2,5,34,70,71,33,21,83
02M282,2016,92,81,81,7,5,9,26,43,9,1,4,26,66,71,21,19,73
02M282,2015,76,66,61,0,3,6,25,37,6,1,1,23,53,56,20,8,68
02M282,2014,93,79,67,0,5,13,23,40,10,0,7,35,58,69,24,9,84
02M288,2017,81,65,65,37,3,6,26,44,4,1,0,41,40,70,11,15,66
02M288,2016,88,73,69,13,8,7,31,45,3,0,2,47,41,73,15,20,68
02M288,2015,82,68,58,2,5,6,33,41,2,0,0,42,40,71,11,15,67
02M288,2014,84,70,67,2,3,1,39,43,1,0,0,42,42,69,15,16,68
02M288,2013,86,76,67,4,6,4,30,50,2,0,0,46,40,66,20,12,74
02M288,2012,94,83,72,1,3,7,35,49,1,2,0,58,36,79,15,14,80
02M288,2011,99,78,67,0,7,7,37,46,9,0,0,42,57,74,25,18,81
02M288,2010,102,68,56,0,10,2,47,49,4,0,0,62,40,84,18,23,79
02M288,2009,82,68,60,0,3,2,36,41,3,0,0,57,25,62,20,15,67
02M288,2008,97,70,67,1,9,2,42,48,4,1,0,49,48,74,23,17,80
02M288,2007,90,69,61,0,8,1,45,37,7,0,0,50,40,74,16,15,75
02M288,2006,102,91,77,0,3,3,45,51,2,1,0,59,43,71,31,18,84
02M288,2005,79,59,48,0,2,4,39,33,3,0,0,47,32,65,14,13,66
02M288,2004,80,53,50,0,16,0,41,36,3,0,0,48,32,53,27,12,68
02M294,2017,95,93,93,0,1,8,26,42,10,2,7,68,27,63,32,27,68
02M294,2016,67,65,65,0,1,5,28,27,4,0,3,37,30,52,15,14,53
02M294,2015,72,63,63,0,2,2,24,36,1,2,7,33,39,46,26,24,48
02M294,2014,85,67,64,0,4,5,35,37,3,0,5,41,44,53,32,18,67
02M294,2013,80,66,64,0,2,5,29,36,10,0,0,35,45,59,21,26,54
02M294,2012,88,70,69,0,4,9,37,29,11,2,0,52,36,59,29,27,61
02M294,2011,89,70,67,0,4,2,35,40,12,0,0,43,46,61,28,21,68
02M294,2010,79,53,52,0,11,2,23,37,16,1,0,35,44,59,20,14,65
02M294,2009,78,47,42,0,9,5,15,49,9,0,0,34,44,59,19,12,66
02M294,2008,85,59,58,0,12,4,28,48,5,0,0,44,41,58,27,21,64
02M294,2007,80,47,12,0,8,6,30,41,1,2,0,43,37,53,27,19,61
02M294,2006,89,64,58,0,9,2,25,51,11,0,0,43,46,67,22,12,77
02M294,2005,70,54,53,0,0,4,17,40,9,0,0,31,39,46,24,9,61
02M294,2004,96,81,48,0,5,9,12,60,14,1,0,48,48,59,37,12,84
02M294,2003,11,0,0,0,4,1,3,7,0,0,0,6,5,9,2,3,8
02M296,2017,88,66,66,0,2,5,24,56,2,1,0,52,36,79,9,20,68
02M296,2016,85,63,62,0,8,6,21,55,2,1,0,53,32,77,8,24,61
02M296,2015,99,69,53,0,7,2,24,70,3,0,0,76,23,92,7,22,77
02M296,2014,81,63,53,0,5,4,23,49,3,1,1,67,14,75,6,15,66
02M296,2013,85,50,47,0,8,1,20,59,4,0,1,67,18,74,11,15,70
02M296,2012,104,77,72,0,8,9,22,70,2,0,1,68,36,91,13,19,85
02M296,2011,103,83,71,0,2,7,18,78,0,0,0,74,29,95,8,16,87
02M296,2010,98,70,62,0,11,7,24,63,4,0,0,63,35,92,6,22,76
02M296,2009,76,46,42,0,13,4,27,45,0,0,0,45,31,66,10,8,68
02M296,2008,97,71,62,0,8,2,31,62,2,0,0,69,28,78,19,22,75
02M296,2007,82,61,57,3,6,5,28,48,1,0,0,55,27,68,14,11,71
02M296,2006,75,58,50,1,5,6,24,41,4,0,0,53,22,50,25,8,67
02M296,2005,91,74,63,6,4,5,32,50,4,0,0,70,21,66,25,3,88
02M296,2004,81,59,39,0,7,0,29,49,2,0,1,56,25,68,13,5,76
02M298,2017,141,105,105,37,8,11,46,70,11,2,1,80,61,115,26,23,118
02M298,2016,131,111,111,29,4,6,45,74,5,0,1,76,55,105,26,26,105
02M298,2015,135,106,103,10,9,5,48,73,5,0,4,79,56,107,28,20,115
02M298,2014,110,92,89,17,5,25,22,49,6,0,8,59,51,83,27,17,93
02M298,2013,92,73,72,9,3,12,29,46,2,0,3,58,34,68,24,10,82
02M298,2012,109,97,94,11,1,4,43,52,1,9,0,67,42,86,23,11,98
02M298,2011,98,85,85,17,1,17,23,29,3,26,0,58,40,77,21,9,89
02M298,2010,95,87,83,18,2,6,47,33,3,6,0,55,40,66,29,11,84
02M298,2009,98,81,81,6,3,4,39,45,4,6,0,51,47,63,35,14,84
02M298,2008,99,84,83,10,3,13,24,54,5,3,0,53,46,73,26,12,87
02M298,2007,94,86,81,28,2,24,31,26,10,3,0,54,40,67,27,9,85
02M298,2006,92,78,76,39,4,12,31,36,7,6,0,48,44,63,29,19,73
02M298,2005,98,82,77,13,2,25,34,23,5,11,0,50,48,66,32,7,91
02M298,2004,115,98,98,41,7,56,18,28,9,4,0,55,60,76,39,4,111
02M300,2017,57,48,48,2,7,9,15,33,0,0,0,16,41,46,11,16,41
02M300,2016,69,48,48,13,10,2,12,53,0,2,0,29,40,59,10,19,50
02M300,2015,84,58,51,4,13,3,21,57,3,0,0,15,69,68,16,20,64
02M300,2014,86,60,51,2,10,1,20,58,2,0,5,33,53,71,15,17,69
02M300,2013,92,53,48,0,12,6,24,57,5,0,0,20,72,66,26,22,70
02M300,2012,81,54,53,0,4,4,21,55,1,0,0,23,58,63,18,16,65
02M300,2011,108,64,64,0,8,11,33,59,4,1,0,35,73,83,25,18,90
02M300,2010,95,59,57,2,8,4,24,64,3,0,0,26,69,76,19,16,79
02M300,2009,80,42,42,1,5,5,23,47,5,0,0,24,56,63,17,19,61
02M300,2008,83,44,44,0,16,5,23,51,4,0,0,20,63,58,25,17,66
02M300,2007,86,47,46,0,5,4,14,61,7,0,0,21,65,67,19,19,67
02M300,2006,80,49,45,0,7,1,12,64,3,0,0,23,57,69,11,7,73
02M300,2005,79,59,57,4,3,6,26,46,1,0,0,21,58,59,20,5,74
02M300,2004,83,57,53,2,5,5,24,49,5,0,0,23,60,56,27,8,75
02M300,2003,6,0,0,0,3,0,3,3,0,0,0,1,5,5,1,1,5
02M303,2017,66,54,54,0,11,2,25,69,2,0,1,22,44,54,12,16,50
02M303,2016,114,95,95,0,9,2,31,71,1,0,1,51,63,94,20,27,87
02M303,2015,99,73,71,0,14,3,25,53,1,0,1,54,45,80,19,23,76
02M303,2014,106,69,67,0,16,1,25,61,1,0,2,51,55,90,16,26,80
02M303,2013,83,55,55,0,12,2,20,75,1,0,0,38,45,53,30,19,64
02M303,2012,90,62,62,0,19,1,26,81,4,1,1,48,42,64,26,23,67
02M303,2011,96,58,57,0,15,2,29,45,2,1,0,44,52,70,26,22,74
02M303,2010,106,60,60,0,18,1,29,41,0,0,0,51,55,76,30,21,85
02M303,2009,98,53,53,0,18,2,28,73,2,0,0,50,48,98,0,20,78
02M303,2008,114,65,65,26,24,0,23,40,3,0,0,59,55,114,0,30,84
02M303,2007,79,38,36,7,16,0,26,84,2,1,1,36,43,75,4,22,57
02M303,2006,71,34,34,0,14,0,23,69,4,0,0,33,38,60,11,13,58
02M303,2005,105,47,47,0,20,0,23,82,1,0,0,42,63,65,40,15,90
02M305,2017,60,53,53,20,3,5,22,32,1,0,0,35,25,56,4,12,48
02M305,2016,64,56,56,6,0,4,19,40,1,0,0,33,31,55,9,12,52
02M305,2015,62,55,50,2,6,3,26,32,1,0,0,39,23,53,9,14,48
02M305,2014,59,47,39,0,7,2,26,29,2,0,0,30,29,55,4,17,42
02M305,2013,67,52,46,0,3,7,20,36,4,0,0,38,29,60,7,13,54
02M305,2012,71,59,52,0,5,5,27,37,2,0,0,43,28,49,22,11,60
02M305,2011,77,66,57,0,2,4,35,35,2,1,0,51,26,59,18,17,60
02M305,2010,59,47,44,0,4,1,26,30,2,0,0,35,24,47,12,7,52
02M305,2009,75,60,56,0,4,6,29,39,1,0,0,38,37,59,16,14,61
02M305,2008,60,37,33,1,8,2,24,32,2,0,0,32,28,46,14,11,49
02M305,2007,59,37,33,1,12,2,25,29,1,1,1,29,30,40,19,11,48
02M305,2006,61,46,40,0,10,1,23,32,5,0,0,38,23,49,12,5,56
02M305,2005,70,50,41,2,9,5,29,28,8,0,0,32,38,44,26,8,62
02M308,2017,76,55,55,3,4,4,26,43,2,1,0,53,23,64,12,29,47
02M308,2016,70,57,57,1,1,7,21,39,2,1,0,50,20,47,23,23,47
02M308,2015,66,47,35,0,8,7,18,39,1,1,0,42,24,45,21,26,40
02M308,2014,78,55,48,1,3,7,21,43,2,1,4,54,24,59,19,27,51
02M308,2013,77,59,48,0,6,10,20,41,2,0,4,57,20,38,39,23,54
02M308,2012,78,56,53,1,4,9,23,41,4,0,1,59,19,46,32,18,60
02M308,2011,85,58,49,0,8,7,25,49,3,0,1,56,29,51,34,29,56
02M308,2010,64,45,40,0,7,5,21,35,2,1,0,35,29,37,27,19,45
02M308,2009,73,51,45,0,6,10,18,41,4,0,0,43,30,73,0,19,54
02M308,2008,60,40,32,2,6,9,22,28,1,0,0,34,26,60,0,23,37
02M308,2007,63,46,34,1,5,4,17,39,2,0,1,39,24,62,1,17,46
02M308,2006,68,46,32,1,6,2,17,42,6,0,1,40,28,50,18,17,51
02M308,2005,67,52,30,2,7,5,31,26,5,0,0,36,31,43,24,11,56
02M313,2017,86,42,42,0,2,2,42,34,7,0,1,49,37,69,17,30,56
02M313,2016,83,18,16,0,4,4,32,46,1,0,0,40,43,67,16,33,50
02M313,2015,110,40,40,0,12,2,53,49,4,1,1,58,52,92,18,28,82
02M313,2014,127,40,39,0,8,3,52,66,6,0,0,67,60,112,15,39,88
02M313,2013,114,42,41,0,14,4,44,57,5,1,3,57,57,88,26,25,89
02M313,2012,101,30,30,0,9,4,59,62,9,1,0,54,47,76,25,16,85
02M313,2011,135,58,57,0,25,3,47,58,6,0,1,85,50,106,29,15,120
02M313,2010,115,39,39,0,16,4,38,51,9,0,1,63,52,89,26,23,92
02M313,2009,103,32,32,0,27,4,45,59,5,2,0,53,50,72,31,11,92
02M313,2008,115,60,57,0,13,3,29,66,11,0,0,56,59,86,29,19,96
02M313,2007,109,47,38,0,11,4,28,36,10,1,0,49,60,61,48,13,96
02M313,2006,79,41,30,0,12,1,35,35,6,1,0,43,36,46,33,11,68
02M313,2005,78,30,15,0,8,2,21,16,4,0,1,35,43,44,34,11,67
02M313,2004,44,13,7,0,4,1,10,8,6,0,0,31,13,23,21,8,36
02M313,2003,25,15,4,0,2,0,47,42,10,1,1,19,6,21,4,3,22
02M316,2017,35,24,24,0,2,5,15,11,3,0,1,35,0,32,3,6,29
02M316,2016,49,40,40,0,1,2,26,17,2,2,0,49,0,41,8,5,44
02M316,2015,47,31,24,0,5,2,33,11,1,0,0,47,0,34,13,6,41
02M316,2014,63,39,34,0,7,1,35,22,1,1,3,63,0,50,13,8,55
02M316,2013,52,37,30,0,9,1,35,15,1,0,0,52,0,39,13,8,44
02M316,2012,90,57,49,1,8,4,40,41,3,0,2,90,0,74,16,19,71
02M316,2011,75,57,52,15,1,8,35,31,1,0,0,75,0,64,11,13,62
02M316,2010,98,68,62,13,9,7,47,43,0,0,1,98,0,80,18,17,81
02M316,2009,81,54,49,2,8,2,35,43,1,0,0,81,0,65,16,13,68
02M316,2008,61,32,32,1,6,1,22,37,1,0,0,61,0,54,7,12,49
02M316,2007,61,37,30,0,4,5,28,36,1,0,2,61,0,49,12,14,47
02M316,2006,72,53,44,8,4,2,19,53,1,1,1,72,0,59,13,7,65
02M316,2005,77,49,32,6,7,0,25,35,1,0,0,77,0,60,17,7,70
02M374,2017,86,82,82,43,3,4,19,55,5,2,1,68,18,69,17,17,69
02M374,2016,110,105,105,28,1,4,44,52,7,1,2,73,37,90,20,14,96
02M374,2015,109,93,88,5,3,4,41,53,6,3,2,82,27,90,19,16,93
02M374,2014,113,79,75,2,1,5,45,51,7,0,5,83,30,95,18,19,94
02M374,2013,128,99,92,3,4,5,57,53,10,0,3,88,40,105,23,20,108
02M374,2012,105,74,64,4,6,6,42,46,7,0,4,68,37,76,29,21,84
02M374,2011,113,93,90,9,6,3,62,54,7,0,0,85,28,83,30,17,96
02M374,2010,126,87,85,4,5,3,54,46,8,0,1,95,31,92,34,13,113
02M374,2009,112,81,76,2,5,4,40,41,10,0,0,77,35,75,37,13,99
02M374,2008,95,62,59,0,10,1,35,30,6,0,0,64,31,55,40,13,82
02M374,2007,72,53,47,2,4,2,47,41,2,1,0,48,24,49,23,9,63
02M374,2006,93,68,51,1,7,0,48,58,6,1,0,53,40,53,40,12,81
02M374,2005,68,50,13,0,4,0,42,26,0,0,0,42,26,40,28,10,58
02M376,2017,116,116,116,0,0,14,13,16,63,3,7,70,46,43,73,20,96
02M376,2016,101,99,99,0,1,8,20,21,49,1,2,56,45,48,53,14,87
02M376,2015,109,107,106,0,0,9,18,31,46,0,5,56,53,48,61,13,96
02M376,2014,112,110,110,0,0,8,25,40,35,1,3,71,41,55,57,11,101
02M376,2013,105,103,103,0,2,9,18,37,35,0,6,64,41,41,64,10,95
02M376,2012,107,103,102,0,1,4,19,55,25,0,4,61,46,56,51,16,91
02M376,2011,100,98,98,0,0,15,25,37,22,0,1,56,44,47,53,10,90
02M376,2010,99,94,91,0,2,15,14,44,26,0,0,46,53,48,51,14,85
02M376,2009,99,89,89,0,3,11,18,43,27,0,0,51,48,54,45,3,96
02M376,2008,99,91,91,0,0,10,28,42,19,0,0,59,40,46,53,4,95
02M392,2017,103,95,95,25,1,7,13,75,5,1,2,35,68,78,25,19,84
02M392,2016,101,93,88,10,2,4,21,69,5,1,1,50,51,87,14,21,80
02M392,2015,91,83,72,2,4,8,24,51,6,0,2,51,40,73,18,15,76
02M392,2014,96,80,71,0,7,4,22,65,3,0,2,39,57,87,9,21,75
02M392,2013,104,88,83,0,6,1,33,64,3,1,2,50,54,86,18,13,91
02M392,2012,96,84,78,3,2,4,27,54,6,1,4,40,56,75,21,17,79
02M392,2011,99,85,76,1,8,4,27,67,1,0,0,33,66,78,21,13,86
02M392,2010,76,63,58,7,2,6,22,40,7,1,0,27,49,58,18,9,67
02M392,2009,87,75,66,4,3,10,20,51,6,0,0,42,45,71,16,13,74
02M393,2017,98,81,81,27,6,1,43,54,2,1,0,44,54,78,20,23,75
02M393,2016,101,80,80,12,8,2,26,59,3,1,0,41,60,70,31,29,72
02M393,2015,91,76,67,1,7,2,24,63,1,1,0,47,44,66,25,18,73
02M393,2014,91,68,52,1,4,4,29,62,1,0,0,30,61,70,21,23,68
02M393,2013,96,75,63,0,4,2,32,59,3,1,0,23,73,59,37,22,74
02M393,2012,85,56,45,1,6,4,31,44,2,0,0,22,63,48,37,15,70
02M393,2011,75,45,36,0,5,0,33,62,3,0,0,24,51,42,33,20,55
02M393,2010,97,57,50,0,10,0,39,44,0,2,0,29,68,62,35,21,76
02M393,2009,81,56,51,3,8,0,36,37,2,0,0,17,64,81,0,18,63
02M394,2017,95,45,45,34,27,38,25,28,4,0,0,42,53,81,14,0,95
02M394,2016,141,73,73,50,38,56,12,53,15,5,0,72,69,130,11,0,141
02M394,2015,75,33,33,16,22,26,3,36,8,2,0,26,49,66,9,0,75
02M394,2014,99,61,61,38,20,57,12,20,10,0,0,50,49,86,13,0,99
02M394,2013,97,44,43,26,29,60,11,15,8,3,0,44,53,86,11,0,97
02M394,2012,59,41,41,27,6,44,4,7,4,0,0,27,32,56,3,0,59
02M394,2011,59,31,31,15,9,40,5,12,2,0,0,28,31,53,6,0,59
02M394,2010,85,40,40,18,19,46,11,23,5,0,0,43,42,75,10,0,85
02M394,2009,83,44,44,26,12,57,6,17,3,0,0,48,35,74,9,0,83
02M394,2008,134,66,66,52,26,89,3,38,4,0,0,66,68,122,12,0,134
02M394,2007,14,1,1,1,2,8,1,5,0,0,0,2,12,12,2,0,14
02M394,2006,10,0,0,0,0,6,1,3,0,0,0,4,6,10,0,0,10
02M399,2017,44,35,35,9,4,8,13,22,0,1,0,22,22,33,11,9,35
02M399,2016,68,52,52,19,2,15,15,34,2,0,2,34,34,57,11,8,60
02M399,2015,84,63,50,5,5,28,21,30,4,0,1,46,38,64,20,18,66
02M399,2014,119,95,82,19,6,40,21,51,5,1,1,73,46,100,19,17,102
02M399,2013,100,80,74,18,3,25,21,45,7,0,2,56,44,80,20,14,86
02M399,2012,96,78,74,4,3,32,21,39,2,0,2,55,41,84,12,17,79
02M399,2011,84,59,55,5,8,28,19,29,4,0,4,41,43,71,13,20,64
02M399,2010,55,28,26,3,4,20,12,19,0,0,4,26,29,51,4,7,48
02M399,2009,81,48,47,13,2,40,9,25,5,0,2,42,39,70,11,8,73
02M400,2017,286,263,263,98,10,37,38,186,19,6,0,144,142,232,54,35,251
02M400,2016,247,220,210,44,10,36,44,150,15,2,0,120,127,206,41,47,200
02M400,2015,250,183,166,32,17,26,51,151,21,0,1,120,130,209,41,49,201
02M400,2014,294,234,209,41,11,42,38,188,22,0,4,165,129,245,49,49,245
02M400,2013,296,227,214,60,9,54,50,166,23,2,1,141,155,240,56,42,254
02M400,2012,309,236,218,41,16,44,44,202,17,0,2,160,149,233,76,48,261
02M400,2011,325,259,234,59,17,61,50,190,24,0,0,151,174,240,85,54,271
02M400,2010,339,278,262,79,18,70,48,182,38,1,0,172,167,249,90,55,284
02M400,2009,308,242,233,70,13,45,42,182,39,0,0,155,153,213,95,35,273
02M400,2008,344,269,251,92,23,53,47,196,48,0,0,167,177,230,114,45,299
02M400,2007,340,273,251,108,16,60,58,184,38,0,0,178,162,213,127,31,309
02M400,2006,352,262,219,80,22,72,75,169,36,0,0,186,166,206,146,43,309
02M400,2005,344,241,191,68,15,68,77,156,41,1,1,169,175,198,146,37,307
02M400,2004,297,236,202,95,11,67,65,109,54,2,0,164,133,150,147,33,264
02M400,2003,312,228,178,68,32,50,63,130,68,0,1,161,151,178,134,27,285
02M400,2002,372,276,222,80,31,57,72,159,83,1,0,201,171,159,213,26,346
02M400,2001,360,271,197,73,26,53,68,145,92,2,0,187,173,144,216,37,323
02M407,2017,71,68,68,0,0,2,12,18,37,0,2,35,36,21,50,14,57
02M407,2016,65,64,64,0,0,5,19,11,27,0,3,28,37,28,37,13,52
02M407,2015,67,62,62,0,0,5,11,9,40,0,2,32,35,19,48,8,59
02M407,2014,69,59,59,0,0,6,10,7,42,1,3,31,38,15,54,1,68
02M407,2013,60,49,49,0,1,2,8,7,33,2,8,40,20,15,45,1,59
02M407,2012,72,63,63,0,0,4,10,14,40,0,4,29,43,12,60,5,67
02M407,2011,70,61,61,0,1,3,9,13,41,1,3,33,37,12,58,9,61
02M407,2010,75,63,63,0,1,9,11,20,27,0,8,40,35,24,51,9,66
02M407,2009,69,63,63,0,1,2,8,11,43,0,5,35,34,15,54,7,62
02M407,2008,65,53,53,0,1,8,9,9,28,0,11,21,44,9,56,13,52
02M407,2007,54,43,37,0,2,2,7,14,23,0,8,32,22,17,37,8,46
02M407,2006,55,42,0,0,2,3,16,14,21,1,0,26,29,16,39,4,51
02M407,2005,58,44,0,0,1,5,11,15,26,1,0,27,31,17,41,6,52
02M407,2004,50,33,0,0,2,1,9,16,24,0,0,24,26,8,42,3,47
02M407,2003,70,55,0,0,2,7,14,16,32,0,1,31,39,18,52,8,62
02M407,2002,53,44,0,0,1,2,17,19,15,0,0,28,25,19,34,3,50
02M407,2001,40,32,0,0,2,6,7,10,17,0,0,20,20,11,29,3,37
02M408,2017,96,95,95,67,0,7,25,20,37,0,7,70,26,36,60,13,83
02M408,2016,115,112,111,33,0,6,16,25,63,1,4,91,24,40,75,11,104
02M408,2015,99,97,88,29,1,7,29,17,42,0,4,74,25,48,51,14,85
02M408,2014,124,116,105,37,1,6,29,30,57,0,2,91,33,58,66,28,96
02M408,2013,97,89,83,24,3,2,30,23,40,0,2,74,23,33,64,13,84
02M408,2012,113,103,99,17,1,3,32,26,52,0,0,80,33,48,65,6,107
02M408,2011,97,91,88,14,0,1,28,20,45,3,0,68,29,38,59,6,91
02M408,2010,93,85,84,18,0,8,23,26,32,3,1,74,19,38,55,2,91
02M408,2009,110,106,101,8,1,6,28,37,35,2,2,75,35,34,76,5,105
02M408,2008,105,97,94,2,0,15,22,25,43,0,0,75,30,39,66,6,99
02M408,2007,100,90,85,10,2,5,25,35,30,0,5,68,32,43,57,2,98
02M408,2006,80,74,61,8,0,5,24,12,38,0,1,59,21,28,52,2,78
02M408,2005,100,95,80,21,1,3,27,20,49,1,0,74,26,21,79,2,98
02M408,2004,81,1,0,0,1,2,24,16,38,0,1,50,31,12,69,11,70
02M408,2003,84,72,61,24,1,5,20,12,46,0,1,59,25,21,63,6,78
02M408,2002,96,87,71,13,2,4,34,18,38,2,0,69,27,24,72,1,95
02M408,2001,80,72,54,15,4,2,27,10,41,0,0,63,17,13,67,0,80
02M411,2017,127,126,125,72,0,43,6,15,56,0,7,71,56,55,72,22,105
02M411,2016,115,114,111,55,0,46,5,23,38,0,3,77,38,51,64,10,105
02M411,2015,112,112,111,71,0,43,2,13,52,0,2,49,63,51,61,17,95
02M411,2014,117,116,112,76,0,57,10,14,33,1,2,82,35,54,63,19,98
02M411,2013,111,111,110,71,0,60,6,17,27,0,1,64,47,61,50,7,104
02M411,2012,108,107,105,55,0,65,9,12,21,0,1,57,51,69,39,9,99
02M411,2011,105,104,104,40,0,64,3,19,18,0,1,58,47,67,38,2,103
02M411,2010,107,107,107,40,0,68,9,14,16,0,0,64,43,72,35,1,106
02M411,2009,115,114,114,55,0,70,5,16,24,0,0,58,57,78,37,3,112
02M411,2008,96,96,96,43,0,54,8,14,20,0,0,59,37,63,33,3,93
02M411,2007,106,105,99,69,0,66,6,9,25,0,0,68,38,71,35,2,104
02M411,2006,105,103,100,56,0,61,7,12,25,0,0,66,39,66,39,3,102
02M411,2005,96,96,94,55,0,57,9,11,19,0,0,59,37,62,34,0,96
02M411,2004,104,101,99,65,1,65,5,14,20,0,0,66,38,72,32,4,100
02M411,2003,94,92,89,64,0,55,3,6,30,0,0,59,35,60,34,2,92
02M411,2002,101,98,90,45,1,51,6,10,34,0,0,73,28,56,45,3,98
02M411,2001,92,92,88,63,0,38,6,14,34,0,0,61,31,36,56,2,90
02M412,2017,109,103,103,72,1,28,1,10,69,0,1,53,56,45,64,26,83
02M412,2016,128,126,126,70,0,25,6,14,70,4,9,61,67,40,88,25,103
02M412,2015,115,110,106,64,0,22,8,17,63,0,5,72,43,41,74,24,91
02M412,2014,124,121,117,73,0,26,6,16,66,0,10,63,61,39,85,16,108
02M412,2013,153,148,146,80,0,40,7,26,72,0,8,89,64,55,98,25,128
02M412,2012,133,130,127,77,0,40,7,26,55,1,4,75,58,56,77,21,112
02M412,2011,163,157,156,80,0,56,14,22,66,0,5,90,73,74,89,19,144
02M412,2010,126,119,116,49,0,33,14,18,61,0,0,67,59,45,81,16,110
02M412,2009,129,117,113,58,0,31,11,19,67,1,0,65,64,38,91,25,104
02M412,2008,131,118,114,52,0,49,7,16,58,1,0,66,65,55,76,17,114
02M412,2007,137,124,121,62,1,43,11,21,60,2,0,68,69,41,96,20,117
02M412,2006,124,113,106,62,2,32,20,16,54,1,1,64,60,33,91,20,104
02M412,2005,133,127,118,77,2,32,13,21,67,0,0,67,66,133,0,18,115
02M412,2004,102,99,92,57,1,33,8,10,49,0,2,52,50,102,0,10,92
02M412,2003,104,102,97,75,0,21,5,11,65,0,2,69,35,104,0,2,102
02M412,2002,102,101,97,64,0,29,6,10,57,0,0,66,36,5,97,3,99
02M412,2001,83,82,80,16,1,15,7,15,46,0,0,49,34,16,67,2,81
02M413,2017,101,97,97,0,0,20,10,30,33,0,8,47,54,45,56,20,81
02M413,2016,106,104,104,0,0,18,11,32,37,0,8,52,54,52,54,20,86
02M413,2015,109,97,97,0,1,18,13,25,46,0,7,48,61,42,67,20,89
02M413,2014,101,94,94,0,0,14,14,27,41,0,5,52,49,41,60,14,87
02M413,2013,100,98,97,0,1,9,15,34,36,1,5,52,48,27,73,17,83
02M413,2012,98,85,85,0,0,19,11,32,29,1,6,57,41,35,63,17,81
02M413,2011,89,83,83,0,0,12,5,22,37,0,13,44,45,23,66,9,80
02M413,2010,90,82,82,0,1,16,14,16,36,0,8,42,48,25,65,12,78
02M413,2009,91,75,75,0,1,20,10,36,19,1,5,39,52,36,55,16,75
02M413,2008,77,64,64,0,5,10,13,17,33,0,4,36,41,19,58,13,64
02M413,2007,88,55,55,0,4,11,18,24,31,0,4,49,39,38,50,11,77
02M413,2006,95,61,61,0,2,13,23,31,27,0,1,53,42,47,48,16,79
02M413,2005,84,73,73,0,2,12,19,23,30,0,0,41,43,28,56,14,70
02M413,2004,96,75,75,0,0,12,16,25,43,0,0,52,44,21,75,18,78
02M413,2003,92,85,84,0,2,21,23,16,32,0,0,38,54,37,55,7,85
02M413,2002,73,56,56,0,3,27,8,18,19,1,0,36,37,35,38,3,70
02M413,2001,71,67,67,0,0,24,7,17,23,0,0,43,28,35,36,7,64
02M414,2017,105,102,102,89,1,23,22,34,23,1,2,58,47,57,48,24,81
02M414,2016,114,110,108,93,1,24,11,50,27,1,1,71,43,77,37,18,96
02M414,2015,95,93,92,62,0,32,11,37,15,0,0,64,31,66,29,10,85
02M414,2014,114,110,108,53,1,46,13,34,18,0,3,60,54,78,36,15,99
02M414,2013,117,117,117,88,0,29,18,54,14,1,1,69,48,86,31,2,115
02M414,2012,119,117,116,91,0,37,15,52,15,0,0,68,51,87,32,10,109
02M414,2011,110,109,109,64,0,39,11,44,16,0,0,57,53,82,28,4,106
02M414,2010,99,96,94,41,0,33,10,36,20,0,0,60,39,72,27,13,86
02M414,2009,125,123,120,62,0,34,14,54,23,0,0,67,58,84,41,19,106
02M414,2008,103,101,101,54,0,38,15,38,12,0,0,63,40,70,33,5,98
02M414,2007,98,94,92,38,0,37,16,28,16,1,0,47,51,61,37,12,86
02M414,2006,106,100,86,5,2,15,23,47,21,0,0,51,55,106,0,17,89
02M414,2005,100,94,80,27,0,11,18,53,18,0,0,56,44,100,0,8,92
02M414,2004,75,69,58,6,3,10,15,34,15,1,0,42,33,75,0,8,67
02M414,2003,52,38,33,7,2,8,20,12,12,0,0,29,23,51,1,6,46
02M414,2002,56,43,39,10,3,13,12,19,12,0,0,31,25,16,40,4,52
02M414,2001,53,45,45,5,0,14,9,17,13,0,0,30,23,31,22,3,50
02M416,2017,133,133,133,131,0,16,1,14,90,6,6,74,59,21,112,21,112
02M416,2016,134,133,133,127,0,23,4,20,84,2,1,81,53,31,103,21,113
02M416,2015,128,126,126,110,0,24,6,13,84,0,1,82,46,31,97,15,113
02M416,2014,143,142,139,117,0,31,7,18,85,0,2,84,59,44,99,17,126
02M416,2013,147,145,145,130,1,35,7,9,94,0,2,85,62,31,116,6,141
02M416,2012,136,136,136,104,0,30,4,9,86,0,7,74,62,25,111,4,132
02M416,2011,129,129,129,117,0,23,7,26,73,0,0,89,40,44,85,1,128
02M416,2010,128,128,128,106,0,30,5,13,79,0,1,84,44,41,87,2,126
02M416,2009,122,122,122,101,0,12,10,11,87,0,2,80,42,26,96,4,118
02M416,2008,137,134,134,114,2,24,8,11,88,0,6,94,43,38,99,2,135
02M416,2007,114,114,114,95,0,18,9,13,71,1,2,77,37,114,0,4,110
02M416,2006,127,127,126,110,0,27,11,11,75,0,3,72,55,127,0,1,126
02M416,2005,115,114,113,76,0,29,9,18,59,0,0,80,35,115,0,2,113
02M416,2004,105,105,101,69,0,26,6,14,58,0,1,63,42,33,72,2,103
02M416,2003,117,116,115,77,0,26,11,8,69,0,3,77,40,31,86,3,114
02M416,2002,101,98,97,0,1,40,9,18,34,0,0,57,44,40,61,4,97
02M418,2017,158,156,155,111,0,86,1,19,41,1,10,101,57,93,65,20,138
02M418,2016,164,163,162,111,1,62,14,14,64,1,9,102,62,78,86,22,142
02M418,2015,141,138,137,108,0,75,7,19,35,0,5,95,46,81,60,14,127
02M418,2014,174,173,168,115,0,67,11,36,55,0,5,102,72,71,103,23,151
02M418,2013,142,141,140,94,1,63,8,25,41,1,4,95,47,63,79,9,133
02M418,2012,171,168,168,105,0,59,13,36,55,0,8,114,57,78,93,11,160
02M418,2011,152,149,149,81,1,57,14,20,60,0,1,95,57,63,89,15,137
02M418,2010,148,145,144,78,0,46,8,37,56,0,1,84,64,56,92,15,133
02M418,2009,178,175,174,104,0,58,8,38,73,0,1,120,58,63,115,12,166
02M418,2008,148,147,144,63,0,37,25,40,46,0,0,88,60,67,81,11,137
02M418,2007,146,134,128,69,0,40,12,45,48,0,1,100,46,146,0,18,128
02M418,2006,150,145,139,68,0,48,22,29,49,0,2,98,52,150,0,10,140
02M418,2005,123,119,106,15,0,34,12,29,48,0,0,68,55,123,0,15,108
02M418,2004,105,101,89,22,2,43,7,24,29,1,1,69,36,61,44,4,101
02M418,2003,107,95,82,21,1,59,9,18,21,0,0,66,41,69,38,9,98
02M418,2002,91,82,68,0,1,46,11,20,14,0,0,48,43,64,27,1,90
02M419,2017,73,59,59,0,3,4,21,45,2,1,0,42,31,65,8,19,54
02M419,2016,84,55,55,0,9,1,25,55,2,1,0,43,41,67,17,13,71
02M419,2015,98,71,71,0,15,1,42,52,2,1,0,57,41,76,22,24,74
02M419,2014,67,49,49,0,5,4,21,39,2,0,1,34,33,59,8,15,52
02M419,2013,75,45,45,0,15,2,19,52,0,0,2,49,26,65,10,21,54
02M419,2012,87,53,52,0,15,6,23,62,3,0,0,44,43,74,13,22,65
02M419,2011,94,38,38,0,17,11,11,79,1,0,0,39,55,79,15,27,67
02M419,2010,102,54,53,0,11,2,23,72,1,0,0,50,52,88,14,16,86
02M419,2009,98,38,37,0,27,2,21,83,5,0,0,58,40,88,10,18,80
02M419,2008,111,50,50,0,35,1,13,81,0,0,0,56,55,84,27,18,93
02M419,2007,95,40,40,0,16,4,25,64,5,0,0,54,41,76,19,15,80
02M419,2006,94,58,58,0,13,4,31,61,4,0,0,59,35,74,20,21,73
02M419,2005,98,60,0,0,7,2,35,41,0,0,0,48,50,77,21,18,80
02M419,2004,100,52,0,0,12,3,33,49,9,1,0,46,54,75,25,20,80
02M419,2003,78,47,0,0,18,2,20,55,2,0,0,41,37,64,14,15,63
02M419,2002,95,58,0,0,15,0,20,65,2,0,0,43,52,65,30,21,74
02M419,2001,79,48,0,0,8,0,31,60,3,0,0,36,43,57,22,11,68
02M420,2017,449,427,427,327,5,101,61,248,31,8,0,328,121,334,115,44,405
02M420,2016,437,418,418,302,6,105,68,223,39,2,0,310,127,319,118,45,392
02M420,2015,425,390,370,174,18,93,75,224,28,4,1,298,127,333,92,47,378
02M420,2014,403,352,335,174,8,94,62,206,35,5,1,296,107,315,88,41,362
02M420,2013,373,328,305,153,6,78,70,188,35,1,1,257,116,235,138,31,342
02M420,2012,379,327,314,119,14,100,74,179,24,2,0,261,118,247,132,50,329
02M420,2011,449,385,354,147,9,98,102,223,26,0,0,316,133,292,157,48,401
02M420,2010,400,342,324,121,17,85,90,199,24,1,1,270,130,250,150,45,355
02M420,2009,368,300,292,73,21,71,86,190,21,0,0,256,112,368,0,39,329
02M420,2008,407,340,338,86,6,89,106,195,16,1,0,298,109,407,0,25,382
02M420,2007,358,283,264,59,7,74,91,171,20,2,0,248,110,356,2,23,335
02M420,2006,341,280,242,49,2,79,86,149,27,0,0,242,99,338,3,19,322
02M420,2005,344,254,213,45,1,87,77,158,19,3,0,214,130,274,70,23,321
02M420,2004,269,207,171,48,1,70,56,128,13,2,0,184,85,210,59,13,256
02M420,2003,246,184,112,21,11,67,67,106,3,0,3,173,73,184,62,10,236
02M420,2002,307,251,194,55,22,76,79,124,27,1,0,232,75,285,22,14,293
02M420,2001,307,235,203,52,28,52,109,128,17,1,0,232,75,296,11,10,297
02M422,2017,82,66,66,37,6,9,23,36,14,0,0,41,41,60,22,20,62
02M422,2016,78,56,56,20,5,5,19,39,14,0,1,26,52,60,18,24,54
02M422,2015,81,66,60,4,5,13,19,26,20,0,3,19,62,50,31,26,55
02M422,2014,79,63,60,8,4,5,22,26,21,1,4,22,57,44,35,30,49
02M422,2013,78,64,56,7,1,10,12,38,16,2,0,21,57,45,33,24,54
02M422,2012,78,58,54,9,5,4,25,24,23,0,2,24,54,33,45,21,57
02M425,2017,93,81,80,25,5,16,23,46,7,0,1,51,42,75,18,19,74
02M425,2016,120,100,100,14,7,6,34,73,5,1,1,61,59,105,15,17,103
02M425,2015,150,112,104,10,9,13,40,91,4,1,1,82,68,124,26,19,131
02M425,2014,111,79,68,4,9,3,35,66,6,0,1,73,38,87,24,25,86
02M425,2013,153,101,85,5,15,6,47,90,5,0,5,86,67,135,18,32,121
02M425,2012,162,110,89,11,21,9,44,102,3,0,4,98,64,115,47,31,131
02M425,2011,162,97,84,2,15,9,47,95,10,1,0,82,80,120,42,31,131
02M425,2010,147,86,76,4,12,14,35,89,8,1,0,82,65,112,35,26,121
02M425,2009,144,85,78,6,14,13,49,67,14,1,0,82,62,100,44,26,118
02M425,2008,155,83,75,10,17,15,54,77,8,1,0,83,72,129,26,31,124
02M425,2007,151,106,85,12,12,8,41,92,10,0,0,72,79,123,28,26,125
02M425,2006,144,78,58,9,23,16,49,77,1,0,1,67,77,106,38,27,117
02M425,2005,143,72,25,0,27,16,32,83,11,0,1,74,69,109,34,25,118
02M425,2004,151,90,45,10,29,23,45,72,11,0,0,81,70,74,77,23,128
02M425,2003,170,97,46,2,27,14,48,92,15,0,1,105,65,139,31,20,150
02M425,2002,121,84,47,19,19,15,31,52,23,0,0,71,50,113,8,12,109
02M425,2001,120,84,15,0,14,13,31,58,18,0,0,69,51,114,6,12,108
02M427,2017,62,39,39,6,4,2,1,71,0,0,0,34,28,61,1,3,59
02M427,2016,52,44,44,4,4,2,2,62,1,0,0,22,30,51,1,9,43
02M427,2015,74,48,45,5,9,1,3,59,2,0,0,33,41,72,2,5,69
02M427,2014,67,52,50,6,5,6,5,76,1,0,0,32,35,65,2,4,63
02M427,2013,66,33,33,0,24,4,9,82,1,0,0,34,32,59,7,1,65
02M427,2012,65,39,38,4,15,0,1,61,0,0,0,37,28,60,5,1,64
02M427,2011,88,43,43,1,21,0,3,46,3,0,0,40,48,73,15,2,86
02M427,2010,96,43,40,0,14,0,2,63,1,0,0,48,48,79,17,10,86
02M429,2011,19,12,8,0,3,2,34,50,2,0,0,9,10,16,3,9,10
02M429,2010,44,14,12,0,18,3,46,54,0,0,0,20,24,35,9,14,30
02M429,2009,88,32,29,0,25,2,34,34,3,0,0,50,38,72,16,20,68
02M429,2008,86,24,21,0,18,4,50,38,1,0,0,47,39,73,13,20,66
02M429,2007,103,31,26,1,24,3,26,41,1,0,0,50,53,90,13,22,81
02M429,2006,73,35,15,0,5,5,32,34,4,0,0,43,30,53,20,13,60
02M429,2005,93,47,18,3,10,8,36,29,2,0,0,48,45,67,26,11,82
02M429,2004,71,27,3,0,24,0,7,12,0,0,0,39,32,50,21,15,56
02M429,2003,76,28,2,0,16,0,22,21,1,0,0,35,41,55,21,15,61
02M429,2002,75,25,0,0,21,0,46,37,2,1,0,40,35,28,47,6,69
02M429,2001,75,16,0,0,21,0,31,40,4,0,1,34,41,46,29,3,72
02M432,2017,75,61,58,5,3,6,22,37,6,1,3,36,39,63,12,17,58
02M432,2016,84,70,59,2,6,3,29,43,3,2,4,41,43,75,9,18,66
02M432,2015,70,46,41,2,8,7,14,40,7,1,1,37,33,63,7,12,58
02M432,2014,67,45,35,1,7,5,25,33,3,0,1,35,32,52,15,21,46
02M432,2013,64,51,42,1,4,3,20,37,3,1,0,33,31,53,11,16,48
02M432,2012,82,55,51,5,9,6,32,41,3,0,0,34,48,72,10,17,65
02M432,2011,79,50,40,1,15,4,25,43,6,1,0,34,45,56,23,19,60
02M432,2010,97,63,51,6,11,10,43,41,3,0,0,40,57,77,20,24,73
02M432,2009,37,10,10,0,9,3,14,17,2,1,0,21,16,27,10,6,31
02M437,2017,111,95,95,7,10,6,32,67,2,0,4,35,76,89,22,31,80
02M437,2016,113,99,98,3,3,8,32,67,3,1,2,39,74,94,19,27,86
02M437,2015,109,82,71,0,7,9,23,71,4,0,2,45,64,88,21,25,84
02M437,2014,109,70,55,0,16,5,32,60,8,2,2,24,85,95,14,24,85
02M437,2013,121,79,58,0,14,9,37,70,4,0,1,39,82,104,17,31,90
02M437,2012,124,100,68,0,3,6,34,78,3,0,3,48,76,92,32,21,103
02M437,2011,117,76,65,0,5,8,32,73,4,0,0,43,74,97,20,23,94
02M437,2010,97,85,76,0,0,7,23,52,12,3,0,28,69,67,30,15,82
02M438,2017,94,80,80,0,6,11,13,56,13,1,0,36,58,85,9,5,89
02M438,2016,88,75,75,0,10,14,23,43,7,1,0,28,60,82,6,2,86
02M438,2015,93,62,55,0,14,18,22,47,6,0,0,40,53,81,12,3,90
02M438,2014,69,48,45,0,8,14,9,40,6,0,0,39,30,54,15,1,68
02M438,2013,83,49,46,0,13,24,17,30,12,0,0,34,49,74,9,3,80
02M438,2012,90,62,60,0,12,26,11,43,10,0,0,40,50,79,11,4,86
02M438,2011,78,38,37,0,13,42,7,24,5,0,0,35,43,67,11,2,76
02M438,2010,92,33,32,0,10,36,8,47,1,0,0,35,57,82,10,5,87
02M439,2017,119,119,119,118,0,13,17,78,11,0,0,67,52,94,25,18,101
02M439,2016,107,106,106,104,0,10,15,73,8,0,1,72,35,85,22,11,96
02M439,2015,106,102,101,97,0,6,18,69,13,0,0,62,44,83,23,20,86
02M439,2014,125,124,124,120,0,11,14,91,9,0,0,77,48,92,33,14,111
02M439,2013,89,86,86,85,0,6,9,64,8,0,2,61,28,66,23,13,76
02M439,2012,95,94,94,91,0,6,13,68,7,0,1,65,30,68,27,8,87
02M439,2011,81,79,78,75,1,5,9,62,2,0,3,59,22,54,27,8,73
02M439,2010,114,113,113,98,0,6,19,81,5,0,3,73,41,84,30,8,106
02M439,2009,113,105,105,90,0,7,19,78,5,0,4,59,54,86,27,9,104
02M439,2008,100,97,96,70,0,8,20,65,6,0,1,66,34,74,26,11,89
02M439,2007,90,87,85,48,0,10,28,47,5,0,0,57,33,65,25,13,77
02M439,2006,110,108,106,45,0,6,35,64,5,0,0,73,37,85,25,10,100
02M439,2005,74,73,67,17,0,5,21,46,2,0,0,45,29,51,23,4,70
02M439,2004,87,78,64,7,4,6,13,61,6,1,0,57,30,61,26,3,84
02M439,2003,86,76,56,3,2,4,32,48,2,0,0,55,31,63,23,9,77
02M439,2002,80,60,47,0,1,10,19,39,12,0,0,47,33,58,22,19,61
02M439,2001,63,54,33,0,1,2,17,30,14,0,0,32,31,46,17,12,51
02M440,2008,178,62,58,0,51,9,52,110,5,1,1,75,103,136,42,26,152
02M440,2007,292,84,53,7,83,28,78,179,6,1,0,146,146,221,71,39,253
02M440,2006,365,139,73,8,68,29,97,223,11,3,2,191,174,269,96,53,312
02M440,2005,400,204,85,10,55,45,99,241,12,1,2,206,194,243,157,57,343
02M440,2004,417,201,54,19,78,49,92,262,11,2,1,206,211,314,103,53,364
02M440,2003,407,131,41,16,92,73,89,229,12,3,1,209,198,308,99,42,365
02M440,2002,510,210,102,34,88,92,133,261,21,3,0,255,255,447,63,45,465
02M440,2001,515,265,121,44,109,149,110,218,37,1,0,262,253,473,42,69,446
02M445,2002,201,117,45,0,62,0,1,2,0,0,0,0,3,189,12,3,0
02M445,2001,329,105,34,0,109,0,1,1,0,0,0,0,2,281,48,2,0
02M449,2017,102,64,64,0,7,5,30,60,4,1,2,52,50,72,30,25,77
02M449,2016,109,85,85,0,3,6,23,73,4,0,3,56,53,86,23,31,78
02M449,2015,99,76,74,0,8,8,22,51,12,1,5,59,40,71,28,23,76
02M449,2014,122,89,89,0,9,4,41,73,2,1,1,66,56,97,25,24,98
02M449,2013,105,76,76,0,11,6,25,67,3,1,3,51,54,73,32,26,79
02M449,2012,101,65,65,0,13,11,29,51,6,1,3,61,40,69,32,18,83
02M449,2011,115,82,82,0,11,11,31,62,10,1,0,60,55,81,34,21,94
02M449,2010,111,83,80,0,12,21,29,59,2,0,0,61,50,90,21,25,86
02M449,2009,95,64,64,0,7,4,29,55,5,2,0,45,50,78,17,26,69
02M449,2008,90,59,59,0,9,8,19,60,3,0,0,52,38,67,23,14,76
02M449,2007,90,58,57,0,8,4,28,54,4,0,0,44,46,68,22,15,75
02M449,2006,89,40,38,0,3,4,26,52,4,3,0,57,32,60,29,18,71
02M449,2005,76,60,56,0,0,3,30,34,7,1,1,39,37,59,17,8,68
02M449,2004,68,32,30,0,5,4,25,31,6,2,0,33,35,54,14,17,51
02M449,2003,61,40,27,0,9,1,12,18,7,1,0,33,28,51,10,9,52
02M449,2002,39,26,0,0,7,3,22,56,8,1,0,19,20,27,12,6,33
02M449,2001,90,48,18,0,10,0,17,39,4,1,0,36,54,46,44,13,77
02M459,2017,72,49,49,0,8,14,9,39,9,0,1,31,41,56,16,1,71
02M459,2016,81,55,44,0,7,6,15,46,13,1,0,42,39,61,20,2,79
02M459,2015,93,57,57,0,15,16,7,48,22,0,0,39,54,65,28,3,90
02M459,2014,73,54,53,0,5,13,13,39,8,0,0,37,36,58,15,3,70
02M459,2013,72,52,51,0,3,18,11,32,11,0,0,37,35,34,38,3,69
02M459,2012,82,62,61,0,6,29,19,21,12,1,0,35,47,52,30,3,79
02M459,2011,70,46,46,0,2,22,11,28,8,0,1,40,30,41,29,2,68
02M459,2010,66,47,47,0,4,41,4,17,4,0,0,39,27,50,16,1,65
02M459,2009,71,40,40,0,4,23,15,21,12,0,0,36,35,71,0,0,71
02M459,2008,66,42,42,0,4,14,12,30,10,0,0,35,31,66,0,1,65
02M459,2007,65,36,36,0,6,14,7,34,10,0,0,28,37,61,4,1,64
02M459,2006,69,38,38,0,5,16,10,30,13,0,0,31,38,59,10,0,69
02M459,2005,68,36,34,0,7,13,9,32,14,0,0,35,33,57,11,0,68
02M459,2004,66,42,31,0,4,18,12,29,7,0,0,39,27,63,3,1,65
02M459,2003,91,52,0,0,5,38,10,34,9,0,0,56,35,81,10,1,90
02M459,2002,55,33,0,0,4,8,4,33,10,0,0,33,22,49,6,0,55
02M459,2001,53,34,0,0,3,22,5,14,12,0,0,23,30,51,2,1,52
02M460,2011,85,43,38,0,26,2,34,47,2,0,0,42,43,68,17,27,58
02M460,2010,177,70,69,1,51,12,60,99,4,2,0,98,79,136,41,40,137
02M460,2009,272,103,102,2,61,17,92,154,8,1,0,151,121,225,47,44,228
02M460,2008,348,130,124,4,93,14,109,219,6,0,0,174,174,254,94,61,287
02M460,2007,407,188,163,9,122,14,120,264,7,2,0,192,215,271,136,61,346
02M460,2006,443,230,177,12,118,21,137,273,11,1,0,250,193,261,182,67,376
02M460,2005,435,159,84,5,145,20,132,269,8,3,3,213,222,277,158,82,353
02M460,2004,588,215,99,23,144,20,190,355,16,3,4,332,256,420,168,81,507
02M460,2003,623,266,142,18,141,30,182,393,16,2,0,330,293,519,104,71,552
02M460,2002,633,288,124,4,140,37,206,368,22,0,0,361,272,581,52,37,596
02M460,2001,562,243,93,23,154,34,169,337,21,1,0,285,277,529,33,42,520
02M475,2017,809,796,796,766,0,578,7,26,168,3,27,321,488,372,437,3,806
02M475,2016,839,833,833,786,0,634,7,19,142,3,34,381,458,399,440,4,835
02M475,2015,821,797,797,769,2,611,8,21,161,5,15,364,457,386,435,0,821
02M475,2014,823,797,797,792,1,627,1,24,135,1,35,353,470,377,446,3,820
02M475,2013,835,804,804,803,1,624,6,18,163,0,24,337,498,347,488,6,829
02M475,2012,800,778,778,764,3,570,9,25,178,2,16,345,455,324,476,5,795
02M475,2011,802,772,772,764,1,575,12,15,188,2,10,311,491,395,407,5,797
02M475,2010,817,784,784,775,0,619,5,18,171,2,2,319,498,413,404,5,812
02M475,2009,838,808,808,795,0,597,9,20,210,2,0,378,460,393,445,5,833
02M475,2008,810,798,798,788,1,574,15,25,195,0,1,319,491,342,468,3,807
02M475,2007,784,761,761,753,2,538,11,30,205,0,0,322,462,301,483,1,783
02M475,2006,787,774,774,770,3,522,24,21,219,0,1,329,458,320,467,2,785
02M475,2005,781,754,754,747,4,505,12,23,238,3,0,355,426,290,491,2,779
02M475,2004,694,679,679,674,1,420,11,19,244,0,0,299,395,211,483,1,693
02M475,2003,690,671,671,668,1,391,18,29,252,0,0,316,374,210,480,1,689
02M475,2002,779,748,748,738,4,405,20,23,330,1,0,304,475,186,593,3,776
02M475,2001,765,748,748,744,2,364,24,26,351,0,0,341,424,171,594,2,763
02M489,2017,174,159,159,43,1,45,42,70,14,1,2,71,103,136,38,35,139
02M489,2016,160,144,143,29,4,36,43,70,10,1,0,77,83,130,30,26,134
02M489,2015,162,145,131,12,2,36,29,76,19,2,0,61,101,118,44,34,128
02M489,2014,171,147,137,17,3,37,44,76,10,2,2,73,98,131,40,29,142
02M489,2013,166,143,134,25,6,47,35,71,13,0,0,72,94,138,28,24,142
02M489,2012,166,128,127,11,15,36,31,79,20,0,0,74,92,123,43,23,143
02M489,2011,199,135,132,18,19,40,44,98,14,3,0,84,115,158,41,26,173
02M489,2010,156,114,105,25,15,47,39,58,12,0,0,68,88,125,31,28,128
02M489,2009,166,118,112,17,21,48,37,61,20,0,0,69,97,113,53,18,148
02M489,2008,206,157,149,31,18,56,46,79,25,0,0,98,108,149,57,21,185
02M489,2007,192,154,138,41,16,65,38,70,19,0,0,76,116,187,5,30,162
02M489,2006,177,136,112,43,13,48,47,55,27,0,0,77,100,171,6,33,144
02M489,2005,134,94,74,23,15,43,27,49,15,0,0,65,69,128,6,15,119
02M489,2004,146,115,79,34,12,52,27,53,14,0,0,73,73,101,45,10,136
02M489,2003,136,101,75,1,12,30,36,58,12,0,0,69,67,91,45,7,129
02M489,2002,148,122,92,27,13,48,27,56,17,0,0,77,71,108,40,6,142
02M489,2001,113,93,64,27,8,25,20,41,26,1,0,61,52,69,44,8,105
02M500,2017,58,55,55,11,0,4,15,36,3,0,0,15,43,52,6,7,51
02M500,2016,49,45,45,0,0,6,16,26,1,0,0,14,35,45,4,12,37
02M500,2015,63,53,47,0,2,1,16,42,2,1,1,20,43,57,6,21,42
02M500,2014,66,55,48,2,1,5,15,49,3,0,1,20,46,56,10,19,47
02M500,2013,73,56,49,0,9,8,19,49,1,0,0,32,41,64,9,16,57
02M500,2012,77,65,59,1,7,3,16,20,2,1,0,26,51,66,11,14,63
02M500,2011,42,33,25,2,4,4,22,26,3,0,0,16,26,38,4,16,26
02M500,2010,55,36,28,2,8,3,29,34,1,2,0,12,43,44,11,20,35
02M500,2009,80,47,40,0,18,1,21,18,1,0,0,42,38,72,8,20,60
02M500,2008,69,43,34,0,11,3,20,16,1,0,0,29,40,59,10,21,48
02M500,2007,59,34,30,0,12,1,31,15,0,0,0,19,40,52,7,18,41
02M500,2006,53,39,31,4,6,1,23,18,0,1,0,23,30,47,6,8,45
02M500,2005,41,21,8,0,6,0,21,42,2,0,1,25,16,34,7,10,31
02M500,2004,40,21,12,0,3,0,22,52,1,3,2,21,19,35,5,10,30
02M500,2003,30,12,9,0,8,0,23,34,0,2,0,13,17,23,7,2,28
02M500,2002,47,15,15,0,17,0,18,35,0,0,0,22,25,26,21,4,43
02M500,2001,43,14,9,0,9,0,13,17,0,0,0,15,28,22,21,2,41
02M507,2017,105,104,104,97,1,4,31,60,8,1,1,17,88,57,48,28,77
02M507,2016,110,107,107,101,0,10,38,55,6,1,0,30,80,71,39,21,89
02M507,2015,111,104,103,37,1,12,44,49,5,1,0,23,88,60,51,21,90
02M507,2014,100,88,84,24,3,9,24,58,7,0,2,25,75,57,43,20,80
02M507,2013,110,91,87,13,2,8,28,66,4,0,4,19,91,66,44,22,88
02M507,2012,120,107,104,16,3,13,41,55,8,3,0,26,94,84,36,18,102
02M507,2011,117,98,93,13,4,7,46,56,7,1,0,29,88,82,35,24,93
02M519,2017,110,108,108,86,1,4,31,52,13,0,10,79,31,67,43,10,100
02M519,2016,128,121,121,52,2,4,37,65,15,1,6,97,31,81,47,19,109
02M519,2015,100,93,93,25,2,4,39,30,15,1,11,86,14,54,46,13,87
02M519,2014,115,113,112,27,2,6,34,54,19,0,2,94,21,57,58,14,101
02M519,2013,126,122,122,42,2,4,47,50,23,0,2,100,26,63,63,11,115
02M519,2012,127,121,121,33,0,4,46,49,28,0,0,105,22,68,59,10,117
02M519,2011,84,79,79,18,0,8,26,35,14,1,0,71,13,47,37,4,80
02M519,2010,175,156,156,59,1,7,68,67,33,0,0,138,37,104,71,4,171
02M519,2009,73,69,69,27,0,3,22,32,16,0,0,50,23,43,30,2,71
02M519,2008,91,86,86,38,1,6,39,33,13,0,0,71,20,54,37,1,90
02M519,2007,85,79,76,30,3,5,30,30,20,0,0,64,21,39,46,4,81
02M519,2006,136,126,119,36,0,5,47,56,25,0,3,110,26,74,62,5,131
02M519,2005,92,82,66,18,0,1,30,35,24,0,2,66,26,47,45,4,88
02M519,2004,94,81,67,36,2,4,48,54,24,2,2,65,29,44,50,3,91
02M519,2003,134,119,96,49,3,1,31,29,19,0,0,101,33,55,79,1,133
02M519,2002,80,67,60,15,5,1,25,25,16,0,0,58,22,73,7,0,80
02M519,2001,67,62,48,0,1,0,40,35,19,0,0,54,13,67,0,10,57
02M520,2017,21,17,17,0,3,1,14,6,0,0,0,11,10,21,0,4,17
02M520,2016,39,27,26,0,7,2,20,16,1,0,0,27,12,27,12,5,34
02M520,2015,62,45,33,0,5,4,25,29,2,0,2,32,30,56,6,14,48
02M520,2014,79,56,46,2,10,9,43,22,4,1,0,39,40,63,16,15,64
02M520,2013,147,79,70,6,27,18,71,51,4,1,2,79,68,109,38,35,112
02M520,2012,220,113,104,0,47,20,99,97,2,1,1,122,98,150,70,56,164
02M520,2011,310,141,130,3,42,33,120,146,8,2,1,146,164,230,80,45,265
02M520,2010,439,205,194,5,42,47,189,187,12,4,0,219,220,338,101,57,382
02M520,2009,518,234,226,13,58,68,173,257,17,3,0,265,253,409,109,63,455
02M520,2008,560,310,299,18,91,72,191,288,7,2,0,285,275,403,157,79,481
02M520,2007,562,328,296,41,80,91,164,290,17,0,0,274,288,446,116,67,495
02M520,2006,637,359,268,31,74,89,225,308,13,0,2,323,314,458,179,91,546
02M520,2005,585,338,245,37,73,134,144,278,29,0,0,292,293,435,150,78,507
02M520,2004,611,306,218,156,117,141,157,291,20,0,2,274,337,430,181,72,539
02M520,2003,525,300,226,150,104,122,123,257,16,1,6,290,235,376,149,57,468
02M520,2002,535,352,287,79,73,141,140,212,41,1,0,306,229,480,55,36,499
02M520,2001,597,404,330,56,73,138,167,242,49,1,0,332,265,553,44,69,528
02M529,2017,65,54,54,14,5,3,10,48,3,1,0,35,30,51,14,13,52
02M529,2016,120,95,94,27,9,9,30,77,4,0,0,54,66,97,23,21,99
02M529,2015,150,82,74,6,18,13,32,98,6,1,0,99,51,112,38,28,122
02M529,2014,136,80,73,1,4,8,31,90,3,2,2,82,54,110,26,27,109
02M529,2013,154,90,83,1,13,7,33,105,8,1,0,84,70,117,37,30,124
02M529,2012,158,98,89,1,15,6,31,111,10,0,0,85,73,115,43,30,128
02M529,2011,183,115,108,5,19,5,38,128,9,3,0,103,80,137,46,30,153
02M529,2010,172,100,94,13,19,9,47,110,6,0,0,100,72,123,49,29,143
02M529,2009,180,111,101,15,19,13,31,132,3,0,1,106,74,140,40,24,156
02M529,2008,203,128,124,24,19,13,46,138,5,1,0,124,79,162,41,24,179
02M529,2007,186,100,88,23,26,11,54,110,11,0,0,113,73,127,59,34,152
02M529,2006,148,96,76,27,15,5,38,96,8,0,1,84,64,106,42,20,128
02M529,2005,174,106,76,23,13,16,42,108,7,1,0,101,73,119,55,17,157
02M529,2004,134,86,65,49,16,6,36,87,5,0,0,77,57,80,54,18,116
02M529,2003,147,80,50,7,16,4,40,98,5,0,0,96,51,116,31,13,134
02M529,2002,144,105,66,6,8,4,39,96,5,0,0,102,42,137,7,11,133
02M529,2001,106,69,40,4,6,1,32,65,7,1,0,76,30,104,2,7,99
02M531,2017,57,54,54,25,1,1,18,29,9,0,0,48,9,46,11,8,49
02M531,2016,57,53,49,11,3,1,24,29,5,0,0,45,12,47,10,9,48
02M531,2015,59,59,57,20,0,2,26,31,5,0,1,49,10,43,16,10,49
02M531,2014,65,62,54,9,0,1,17,33,2,0,1,53,12,50,15,11,54
02M531,2013,54,51,49,6,1,1,23,23,6,0,2,47,7,43,11,5,49
02M531,2012,55,53,52,12,0,1,29,18,3,0,0,49,6,42,13,5,50
02M531,2011,57,57,56,7,0,2,22,19,2,0,0,49,8,50,7,5,52
02M531,2010,51,49,48,2,0,1,21,22,5,0,0,33,18,33,18,2,49
02M531,2009,45,43,43,1,0,3,16,21,3,1,0,38,7,34,11,0,45
02M531,2008,46,41,41,2,1,0,23,26,8,0,0,37,9,36,10,5,41
02M531,2007,39,32,25,2,3,0,22,30,5,0,0,28,11,28,11,4,35
02M531,2006,49,42,29,0,4,0,22,19,5,0,0,38,11,40,9,4,45
02M531,2005,44,39,28,0,0,0,19,17,3,0,0,32,12,33,11,2,42
02M531,2004,40,35,17,0,1,0,21,18,1,0,0,27,13,28,12,6,34
02M531,2003,35,29,14,0,2,0,16,17,2,0,0,25,10,23,12,2,33
02M531,2002,45,31,17,0,10,0,24,18,3,0,0,32,13,42,3,2,43
02M531,2001,36,17,3,0,7,0,18,15,3,0,0,21,15,35,1,3,33
02M533,2017,89,75,75,70,4,11,18,55,5,0,0,59,30,79,10,13,76
02M533,2016,79,71,69,54,1,11,14,47,7,0,0,52,27,69,10,7,72
02M533,2015,94,74,64,10,6,11,27,48,7,0,1,64,30,79,15,15,79
02M533,2014,90,75,70,13,3,14,13,57,4,1,1,72,18,78,12,15,75
02M533,2013,91,70,65,9,3,14,23,47,5,0,2,70,21,69,22,10,81
02M533,2012,96,84,72,9,1,20,19,50,3,1,3,57,39,76,20,11,85
02M534,2017,108,96,96,0,1,4,21,51,28,0,4,57,51,64,44,28,80
02M534,2016,115,99,98,0,1,10,25,52,20,0,8,64,51,71,44,35,80
02M534,2015,106,90,86,0,4,7,24,57,16,1,1,60,46,70,36,32,74
02M534,2014,118,98,97,0,2,9,35,45,25,0,4,68,50,67,51,30,88
02M534,2013,96,83,82,0,2,3,24,41,26,0,2,55,41,45,51,27,69
02M534,2012,118,104,103,0,1,11,19,76,11,0,1,69,49,82,36,16,102
02M535,2004,6,1,0,0,3,11,160,187,12,2,0,1,5,6,0,42,297
02M535,2003,9,2,0,0,4,0,1,1,0,0,0,2,7,8,1,86,286
02M535,2002,339,162,51,0,129,0,3,3,0,0,0,163,176,306,33,2,0
02M535,2001,372,127,54,2,126,0,4,5,0,0,0,159,213,314,58,6,0
02M542,2017,144,133,133,127,3,1,0,125,0,0,1,75,69,124,20,6,138
02M542,2016,127,114,114,89,2,0,1,142,1,0,0,66,61,107,20,7,120
02M542,2015,106,96,94,61,4,0,1,104,0,0,1,55,51,89,17,8,98
02M542,2014,122,113,113,68,1,0,1,90,0,0,0,63,59,99,23,0,122
02M542,2013,123,100,96,49,1,0,0,122,0,0,0,66,57,86,37,2,121
02M542,2012,120,112,112,54,4,0,0,123,0,0,0,63,57,89,31,6,114
02M542,2011,122,112,110,52,0,0,0,120,0,0,0,58,64,94,28,1,121
02M542,2010,141,107,107,41,7,0,0,122,0,0,0,72,69,105,36,3,138
02M542,2009,148,87,87,20,7,0,0,141,0,0,0,69,79,148,0,2,146
02M542,2008,102,86,86,37,3,0,0,148,0,0,0,53,49,102,0,0,102
02M542,2007,116,80,74,12,17,0,0,102,0,0,0,61,55,116,0,2,114
02M542,2006,111,77,63,16,15,0,0,116,0,0,0,41,70,108,3,0,111
02M542,2005,107,63,42,9,10,0,0,111,0,0,0,60,47,107,0,0,107
02M542,2004,94,72,37,24,2,0,0,107,0,0,0,48,46,94,0,1,93
02M542,2003,91,57,23,3,6,0,0,94,0,0,0,47,44,87,4,2,89
02M543,2017,100,87,87,0,7,5,34,57,3,0,1,68,32,79,21,25,75
02M543,2016,100,81,81,0,8,4,37,54,3,1,1,51,49,78,22,32,68
02M543,2015,85,65,48,0,6,5,31,47,1,0,1,42,43,69,16,23,62
02M543,2014,95,80,67,0,3,8,33,46,4,0,4,58,37,75,20,30,65
02M543,2013,71,65,49,0,0,4,18,44,3,0,2,37,34,41,30,17,54
02M543,2012,95,74,65,0,5,8,29,51,4,1,2,70,25,56,39,21,74
02M543,2011,99,73,64,0,13,4,25,68,2,0,0,64,35,61,38,28,71
02M543,2010,90,69,59,0,5,3,24,58,0,4,1,50,40,60,30,26,64
02M543,2009,93,71,62,0,4,4,32,54,3,0,0,59,34,93,0,22,71
02M543,2008,91,69,66,0,4,3,26,57,4,1,0,49,42,91,0,11,80
02M543,2007,89,63,47,0,16,3,33,50,1,2,0,59,30,85,4,15,74
02M543,2006,101,68,43,0,8,5,27,63,4,1,1,56,45,70,31,28,73
02M543,2005,81,56,42,0,6,4,27,48,2,0,0,51,30,68,13,15,66
02M543,2004,91,64,46,0,9,5,26,54,6,0,0,46,45,72,19,11,80
02M543,2003,72,56,33,0,6,4,30,33,5,0,0,39,33,47,25,9,63
02M544,2017,124,27,26,0,8,4,40,74,6,0,0,67,57,105,19,41,83
02M544,2016,152,27,23,0,22,3,51,91,7,0,0,76,76,129,23,46,106
02M544,2015,155,29,15,0,44,2,54,92,4,2,1,84,71,132,23,39,116
02M544,2014,126,13,8,0,21,1,45,70,10,0,0,71,55,114,12,24,102
02M544,2013,118,21,16,0,23,2,36,64,14,2,0,59,59,97,21,21,97
02M544,2012,143,16,12,0,29,4,51,77,7,4,0,84,59,121,22,27,116
02M544,2011,133,11,10,1,49,6,45,77,3,2,0,60,73,114,19,16,117
02M544,2010,120,11,11,1,24,2,54,61,3,0,0,62,58,99,21,17,103
02M544,2009,162,21,18,1,34,8,65,85,2,2,0,80,82,138,24,21,141
02M544,2008,217,29,20,1,46,12,69,123,10,3,0,111,106,169,48,16,201
02M544,2007,225,42,20,0,49,12,69,133,9,2,0,113,112,185,40,29,196
02M544,2006,145,25,10,0,19,5,54,83,3,0,0,73,72,118,27,17,128
02M544,2005,160,29,8,0,24,7,61,88,2,2,0,89,71,120,40,13,147
02M544,2004,115,25,8,0,8,3,44,58,10,0,0,61,54,95,20,17,98
02M544,2003,171,23,5,0,27,4,60,97,8,1,1,90,81,127,44,15,156
02M544,2002,215,28,4,0,14,6,86,110,13,0,0,117,98,163,52,10,205
02M544,2001,228,22,0,0,14,4,96,118,9,1,0,125,103,164,64,19,209
02M545,2017,99,96,96,95,1,96,1,0,2,0,0,59,40,92,7,3,96
02M545,2016,101,99,99,97,0,88,4,6,2,0,1,56,45,89,12,5,96
02M545,2015,88,87,86,80,0,73,4,7,2,0,2,55,33,79,9,3,85
02M545,2014,99,98,98,91,0,87,3,5,1,0,3,67,32,88,11,1,98
02M545,2013,97,97,97,86,0,84,4,7,2,0,0,52,45,90,7,2,95
02M545,2012,114,112,112,97,0,105,2,6,0,0,1,54,60,108,6,3,111
02M545,2011,97,90,90,78,2,88,2,6,0,0,1,45,52,90,7,3,94
02M545,2010,88,82,82,77,1,84,2,1,0,0,1,46,42,81,7,5,83
02M545,2009,87,82,82,71,0,81,2,1,2,0,1,44,43,77,10,3,84
02M545,2008,80,69,69,55,0,68,6,5,1,0,0,38,42,70,10,0,80
02M545,2007,77,71,69,54,0,70,4,3,0,0,0,34,43,77,0,0,77
02M545,2006,54,50,48,44,0,48,4,1,1,0,0,25,29,53,1,1,53
02M545,2005,76,68,64,56,2,67,1,5,2,0,1,45,31,75,1,0,76
02M545,2004,72,56,52,45,2,63,4,3,1,0,1,34,38,68,4,1,71
02M545,2003,52,41,38,34,1,50,0,2,0,0,0,22,30,48,4,0,52
02M546,2017,109,101,101,0,0,7,27,60,12,0,3,18,91,64,45,29,80
02M546,2016,110,104,104,0,1,16,24,56,12,1,1,17,93,70,40,25,85
02M546,2015,107,99,84,0,3,9,19,67,11,0,1,27,80,78,29,26,81
02M546,2014,113,94,89,0,1,7,31,65,5,1,4,22,91,81,32,29,84
02M546,2013,108,90,83,0,9,10,36,42,14,1,5,22,86,71,37,28,80
02M546,2012,120,113,108,0,0,17,33,54,12,0,4,28,92,82,38,24,96
02M550,2017,155,57,56,6,68,14,33,94,14,0,0,57,98,118,37,6,149
02M550,2016,150,79,76,9,41,20,31,84,15,0,0,71,79,118,32,5,145
02M550,2015,127,52,48,9,47,18,26,71,11,1,0,53,74,95,32,4,123
02M550,2014,196,75,71,8,72,14,45,120,15,2,0,76,120,112,84,8,188
02M550,2013,95,28,28,3,38,11,20,53,10,1,0,28,67,37,58,4,91
02M550,2012,76,33,32,2,25,9,24,35,7,0,1,30,46,35,41,2,74
02M550,2011,91,37,35,0,26,13,23,42,12,1,0,31,60,46,45,5,86
02M550,2010,99,39,39,10,28,31,20,38,10,0,0,42,57,59,40,5,94
02M550,2009,115,41,41,14,32,37,11,55,11,1,0,53,62,115,0,3,112
02M550,2008,84,39,37,4,17,19,17,29,19,0,0,29,55,84,0,4,80
02M550,2007,83,37,29,8,23,22,19,32,10,0,0,36,47,79,4,4,79
02M550,2006,97,48,30,7,19,30,12,29,26,0,0,34,63,93,4,3,94
02M550,2005,113,62,46,17,19,31,15,47,20,0,0,47,66,113,0,4,109
02M550,2004,106,46,37,9,29,26,17,43,20,0,0,46,60,102,4,4,102
02M550,2003,158,63,36,9,70,33,22,81,22,0,0,69,89,118,40,6,152
02M550,2002,103,56,36,7,33,25,13,59,6,0,0,39,64,70,33,0,103
02M550,2001,66,0,0,0,49,27,4,29,6,0,0,20,46,38,28,0,66
02M551,2017,126,110,110,57,5,11,22,44,39,2,8,32,94,63,63,32,94
02M551,2016,122,102,102,24,7,11,24,54,25,1,7,51,71,65,57,26,96
02M551,2015,94,75,70,6,2,4,18,39,28,0,5,34,60,55,39,21,73
02M551,2014,99,80,76,4,5,5,16,38,34,0,6,35,64,50,49,22,77
02M551,2013,84,65,62,6,5,1,17,47,16,2,1,41,43,47,37,19,65
02M551,2012,99,78,76,5,3,1,20,59,16,2,1,31,68,62,37,16,83
02M551,2011,104,80,80,10,3,5,31,55,13,0,0,36,68,67,37,18,86
02M551,2010,89,66,65,10,6,2,38,45,4,0,0,23,66,57,32,11,78
02M551,2009,89,61,57,4,7,2,36,44,4,0,0,39,50,70,19,14,75
02M551,2008,86,74,71,14,4,3,30,56,1,0,0,43,43,67,19,11,75
02M551,2007,90,61,54,6,14,2,29,69,1,2,0,35,55,90,0,19,71
02M551,2006,77,62,42,28,14,3,21,75,0,0,0,30,47,77,0,14,63
02M551,2005,82,52,24,5,8,0,35,39,15,0,0,29,53,81,1,9,73
02M551,2004,103,70,31,12,7,0,31,45,0,1,0,40,63,84,19,9,94
02M551,2003,99,56,21,7,7,0,22,59,1,0,0,45,54,73,26,6,93
02M560,2017,196,96,96,2,4,11,58,71,50,2,4,104,92,131,65,61,135
02M560,2016,262,97,95,1,4,10,86,109,51,1,5,149,113,183,79,79,183
02M560,2015,244,83,79,4,9,16,79,99,43,2,5,142,102,173,71,53,191
02M560,2014,226,90,87,4,16,12,88,80,38,2,6,136,90,133,93,54,172
02M560,2013,278,87,86,0,10,10,104,122,38,1,3,170,108,152,126,42,236
02M560,2012,230,85,81,0,1,19,74,91,38,1,7,139,91,137,93,41,189
02M560,2011,235,84,84,0,15,15,65,95,51,6,3,136,99,145,90,46,189
02M560,2010,241,65,61,0,5,14,76,93,53,3,2,141,100,160,81,35,206
02M560,2009,231,84,84,0,17,12,70,107,40,2,0,134,97,147,84,14,217
02M560,2008,265,83,82,0,19,11,100,105,46,2,1,160,105,165,100,29,236
02M560,2007,310,123,120,0,21,24,106,114,62,4,0,187,123,179,131,30,280
02M560,2006,235,106,98,0,2,17,79,81,56,1,1,126,109,137,98,23,212
02M560,2005,198,74,57,0,3,6,71,75,42,3,1,96,102,116,82,34,164
02M560,2004,205,77,44,0,6,14,83,60,46,1,1,121,84,81,124,23,182
02M560,2003,290,92,53,0,2,12,101,107,67,0,3,144,146,100,190,35,255
02M560,2002,307,81,1,0,0,20,104,103,79,1,0,172,135,106,201,20,287
02M560,2001,279,79,1,0,1,19,92,89,78,1,0,148,131,111,168,16,263
02M565,2017,44,25,25,0,0,3,13,16,11,0,1,32,12,28,16,15,29
02M565,2016,36,14,14,0,0,4,10,13,8,1,0,19,17,24,12,8,28
02M565,2015,42,25,25,0,1,2,13,15,11,0,1,24,18,27,15,8,34
02M565,2014,54,24,24,0,1,1,15,24,14,0,0,37,17,33,21,7,47
02M565,2013,41,20,20,0,2,1,14,11,15,0,0,26,15,19,22,5,36
02M565,2012,29,13,13,0,2,4,9,10,6,0,0,19,10,17,12,4,25
02M565,2011,32,14,14,0,2,4,13,8,7,0,0,16,16,15,17,3,29
02M565,2010,57,23,23,0,1,2,15,21,18,0,1,35,22,31,26,5,52
02M565,2009,38,14,14,0,1,4,12,11,8,2,1,28,10,18,20,2,36
02M565,2008,51,16,16,0,1,3,18,20,10,0,0,24,27,28,23,3,48
02M565,2007,32,14,14,0,1,3,13,10,16,0,4,17,15,15,17,1,31
02M565,2006,46,19,19,0,1,1,12,10,6,0,0,33,13,24,22,4,42
02M565,2005,29,8,8,0,1,2,9,6,8,0,1,16,13,13,16,2,27
02M565,2004,26,11,11,0,1,1,15,10,12,0,0,14,12,8,18,1,25
02M565,2003,32,5,4,0,2,0,12,9,10,1,0,17,15,14,18,0,32
02M565,2002,38,11,0,0,2,0,14,4,12,0,2,28,10,21,17,2,36
02M565,2001,43,25,0,0,4,0,19,13,11,0,0,21,22,40,3,0,43
02M570,2017,80,8,8,0,10,1,30,48,1,0,0,50,30,68,12,14,66
02M570,2016,91,8,8,0,12,1,31,53,2,1,3,57,34,78,13,20,71
02M570,2015,103,11,10,0,10,1,38,61,2,0,0,61,42,76,27,27,76
02M570,2014,99,7,7,0,20,3,42,77,2,1,0,61,38,84,15,23,76
02M570,2013,102,14,11,0,14,3,35,51,1,0,0,69,33,79,23,22,80
02M570,2012,116,11,11,0,22,3,40,78,3,0,0,66,50,99,17,28,88
02M570,2011,125,37,37,0,29,1,45,73,4,1,0,71,54,114,11,13,112
02M570,2010,90,23,21,0,14,2,37,58,4,2,0,46,44,79,11,15,75
02M570,2009,124,38,37,0,17,12,150,201,14,1,1,79,45,103,21,13,111
02M570,2008,124,35,34,0,17,14,133,172,9,2,0,86,38,106,18,15,109
02M570,2007,103,22,15,0,25,8,127,172,7,0,1,60,43,81,22,7,96
02M570,2006,379,48,30,0,41,7,118,174,8,1,2,207,172,294,85,35,344
02M570,2005,330,53,32,0,51,9,110,151,12,2,0,193,137,253,77,24,306
02M570,2004,315,60,3,0,11,13,142,192,22,0,0,170,145,240,75,31,284
02M570,2003,310,42,4,0,19,0,24,73,4,1,1,152,158,237,73,31,279
02M570,2002,284,41,0,0,40,0,37,58,2,2,0,160,124,229,55,26,258
02M570,2001,369,69,0,0,43,0,36,77,3,0,0,204,165,337,32,22,347
02M575,2017,242,45,45,1,31,40,84,104,10,4,0,108,134,199,43,13,229
02M575,2016,319,61,60,1,60,59,102,141,16,0,1,127,192,270,49,40,279
02M575,2015,277,62,62,1,74,63,78,115,16,1,4,126,151,246,31,17,260
02M575,2014,279,57,57,2,74,73,74,113,15,3,1,118,161,245,34,24,255
02M575,2013,245,28,28,3,75,67,74,87,16,1,0,96,149,203,42,18,227
02M575,2012,253,45,45,2,61,59,76,102,14,1,1,125,128,220,33,7,246
02M575,2011,225,50,50,3,56,59,81,66,19,0,0,106,119,188,37,7,218
02M575,2010,309,104,104,15,69,106,105,83,13,2,0,133,176,270,39,8,301
02M575,2009,324,75,73,21,89,123,83,101,16,1,0,147,177,278,46,10,314
02M575,2008,355,116,108,31,98,137,102,102,14,0,0,169,186,293,62,9,346
02M575,2007,355,141,125,42,77,122,116,90,26,0,1,149,206,295,60,15,340
02M575,2006,260,118,105,29,44,92,101,46,19,1,1,109,151,228,32,8,252
02M575,2005,187,98,91,31,35,79,47,40,21,0,0,89,98,164,23,4,183
02M575,2004,269,119,102,39,47,127,70,47,24,0,1,132,137,240,29,3,266
02M575,2003,312,71,62,13,68,67,105,102,36,2,0,148,164,268,44,13,299
02M575,2002,460,165,117,13,69,132,166,114,46,2,0,226,234,400,60,21,439
02M575,2001,346,127,32,3,45,97,115,91,41,2,0,166,180,301,45,8,338
02M580,2017,86,72,72,7,1,4,21,56,3,1,1,52,34,75,11,22,64
02M580,2016,135,110,104,4,4,7,40,80,5,2,1,92,43,105,30,21,114
02M580,2015,115,93,80,4,7,12,30,67,4,2,0,78,37,94,21,17,98
02M580,2014,117,87,77,5,15,8,31,72,2,1,3,77,40,100,17,20,97
02M580,2013,116,72,63,4,14,8,40,64,4,0,0,83,33,95,21,25,91
02M580,2012,111,74,61,8,22,7,39,63,2,0,0,78,33,88,23,32,79
02M580,2011,122,75,71,1,13,5,30,86,1,0,0,71,51,105,17,28,94
02M580,2010,130,87,77,7,14,3,48,77,1,1,0,90,40,104,26,34,96
02M580,2009,127,86,80,6,15,3,41,75,5,3,0,91,36,102,25,17,110
02M580,2008,125,87,78,10,17,2,47,70,4,2,0,85,40,97,28,32,93
02M580,2007,126,67,59,8,25,7,44,69,4,1,1,77,49,90,36,20,106
02M580,2006,134,87,71,16,15,7,52,70,2,1,2,93,41,89,45,20,114
02M580,2005,133,73,58,19,27,4,42,82,3,2,0,93,40,100,33,18,115
02M580,2004,119,67,40,15,23,2,38,75,4,0,0,75,44,86,33,19,100
02M580,2003,159,75,45,7,27,4,62,82,10,0,1,109,50,100,59,25,134
02M580,2002,176,102,54,1,15,5,60,105,6,0,0,145,31,137,39,31,145
02M580,2001,179,110,71,16,12,3,74,92,9,1,0,150,29,128,51,42,137
02M586,2017,29,15,15,1,2,1,11,13,4,0,0,19,10,23,6,5,24
02M586,2016,31,9,9,0,4,1,7,18,4,0,0,17,14,26,5,11,20
02M586,2015,30,9,8,1,4,1,8,14,4,0,2,18,12,25,5,9,21
02M586,2014,36,7,7,0,4,2,14,11,3,0,0,22,14,31,5,16,20
02M586,2013,29,4,4,0,14,1,8,20,1,1,0,16,13,23,6,18,11
02M586,2012,30,6,6,0,3,2,7,18,5,0,0,17,13,28,2,13,17
02M586,2011,31,8,8,0,6,1,13,16,1,0,0,17,14,24,7,9,22
02M586,2010,31,8,8,0,7,2,11,14,3,0,0,20,11,27,4,3,28
02M586,2009,53,9,9,0,19,2,17,20,1,0,0,31,22,43,10,7,46
02M586,2008,32,9,8,0,11,3,13,12,0,0,0,12,20,23,9,7,25
02M586,2007,31,10,5,0,7,0,13,15,3,0,0,9,22,26,5,8,23
02M586,2006,30,12,7,0,7,0,10,23,3,0,0,16,14,22,8,6,24
02M586,2005,30,9,2,0,8,0,14,15,2,0,0,18,12,25,5,6,24
02M586,2004,40,6,2,0,7,0,25,21,7,0,0,17,23,30,10,7,33
02M586,2003,43,8,3,0,13,0,10,18,2,0,0,23,20,29,14,10,33
02M586,2002,28,9,3,0,4,0,14,22,6,0,1,19,9,20,8,3,25
02M586,2001,29,7,0,0,6,0,13,12,4,0,0,17,12,19,10,5,24
02M600,2017,334,314,312,235,8,15,95,198,25,0,1,300,34,271,63,56,278
02M600,2016,343,312,312,256,10,27,102,194,19,1,0,321,22,290,53,41,302
02M600,2015,356,302,298,99,14,18,137,189,11,0,1,333,23,299,57,55,301
02M600,2014,382,344,329,124,7,29,140,196,13,1,3,356,26,319,63,55,327
02M600,2013,386,344,336,93,6,27,161,175,17,3,3,366,20,326,60,59,327
02M600,2012,456,409,408,88,4,15,161,263,14,1,2,422,34,379,77,52,404
02M600,2011,360,294,286,70,10,15,127,204,12,1,1,331,29,294,66,42,318
02M600,2010,359,306,301,71,11,15,142,183,17,1,1,335,24,293,66,38,321
02M600,2009,357,305,296,42,7,10,142,184,15,4,2,334,23,269,88,37,320
02M600,2008,389,313,308,50,16,19,162,193,14,0,1,352,37,307,82,38,351
02M600,2007,384,324,296,55,11,21,160,185,18,0,0,348,36,295,89,47,337
02M600,2006,416,365,324,40,10,13,154,219,22,3,5,387,29,323,93,40,376
02M600,2005,403,314,252,25,20,12,143,226,20,2,0,361,42,297,106,46,357
02M600,2004,348,296,185,135,12,18,120,185,22,2,1,314,34,265,83,29,319
02M600,2003,335,275,185,133,21,11,121,186,15,0,2,301,34,316,19,35,300
02M600,2002,383,298,193,14,25,8,135,204,36,0,0,337,46,372,11,35,348
02M600,2001,415,302,249,29,36,15,139,229,32,0,0,357,58,407,8,66,349
02M605,2017,69,64,64,0,0,6,14,39,5,2,3,46,23,60,9,13,56
02M605,2016,53,49,49,0,0,1,17,33,2,0,0,25,28,40,13,10,43
02M605,2015,66,62,62,0,0,3,15,43,4,1,0,30,36,52,14,12,54
02M605,2014,55,47,47,0,0,5,15,29,6,0,0,33,22,42,13,3,52
02M605,2013,53,38,38,0,2,2,15,28,7,0,1,30,23,42,11,12,41
02M605,2012,47,35,35,0,1,2,11,28,5,0,1,28,19,33,14,5,42
02M605,2011,76,54,54,0,3,3,27,38,5,0,3,32,44,55,21,7,69
02M605,2010,67,48,48,0,1,5,22,34,6,0,0,42,25,49,18,5,62
02M605,2009,54,38,38,0,4,7,12,24,10,1,0,31,23,36,18,4,50
02M605,2008,47,32,32,0,5,3,11,28,4,1,0,22,25,34,13,3,44
02M605,2007,63,52,52,0,1,5,13,34,9,2,0,39,24,40,23,12,51
02M605,2006,48,39,38,9,1,2,14,16,3,0,0,27,21,29,19,4,44
02M605,2005,35,21,20,3,4,4,22,22,3,0,0,18,17,11,24,3,32
02M605,2004,51,23,22,7,6,3,24,21,10,0,0,34,17,30,21,7,44
02M605,2003,58,35,19,0,7,1,16,16,10,1,0,33,25,45,13,6,52
02M605,2002,44,23,3,0,11,0,15,26,7,0,0,15,29,12,32,5,39
02M605,2001,51,30,7,0,3,0,16,22,13,0,0,31,20,12,39,5,46
02M615,2017,108,93,93,87,3,11,27,68,1,0,1,30,78,88,20,22,86
02M615,2016,97,84,83,52,4,10,20,63,4,0,0,27,70,82,15,19,78
02M615,2015,96,73,71,14,1,12,21,59,4,0,0,33,63,76,20,17,79
02M615,2014,94,69,65,19,7,14,19,51,5,1,4,23,71,88,6,15,79
02M615,2013,99,71,66,17,12,8,27,58,5,0,1,42,57,83,16,23,76
02M615,2012,94,66,61,11,4,10,31,52,0,0,1,45,49,83,11,19,75
02M615,2011,97,83,75,14,8,5,32,55,3,1,1,35,62,83,14,19,78
02M615,2010,81,62,61,11,8,9,27,45,0,0,0,30,51,61,20,12,69
02M615,2009,93,71,66,24,14,2,22,66,2,1,0,30,63,77,16,19,74
02M615,2008,133,81,79,17,19,10,43,79,1,0,0,43,90,97,36,21,112
02M615,2007,153,70,59,9,37,7,54,92,0,0,0,49,104,111,42,19,134
02M615,2006,173,83,54,8,43,3,70,94,5,1,0,64,109,131,42,34,139
02M615,2005,170,86,50,22,31,2,64,101,1,1,1,68,102,170,0,30,140
02M615,2004,215,104,59,27,32,8,72,132,3,0,0,103,112,215,0,30,185
02M615,2003,171,60,29,0,42,7,59,100,3,0,2,65,106,168,3,24,147
02M615,2002,205,90,47,0,41,7,78,111,8,1,0,74,131,203,2,24,181
02M615,2001,183,67,34,0,40,5,63,101,14,0,0,60,123,156,27,40,143
02M620,2010,63,36,29,1,18,6,101,305,6,1,0,27,36,53,10,23,40
02M620,2009,419,177,163,5,94,10,137,352,15,2,0,197,222,368,51,64,355
02M620,2008,516,175,156,2,86,13,159,375,3,2,0,258,258,423,93,89,427
02M620,2007,552,272,208,5,95,23,100,338,3,0,0,275,277,447,105,79,473
02M620,2006,464,222,133,11,105,8,65,286,2,0,1,213,251,354,110,67,397
02M620,2005,362,134,72,3,75,18,106,379,4,1,1,168,194,225,137,52,310
02M620,2004,509,180,81,41,106,35,120,332,7,1,3,251,258,365,144,85,424
02M620,2003,498,196,87,68,124,24,123,414,14,3,0,263,235,356,142,73,425
02M620,2002,578,249,103,12,143,41,170,373,17,2,0,290,288,486,92,50,528
02M620,2001,603,253,132,14,121,0,0,1,0,0,0,336,267,510,93,87,516
02M625,2012,121,70,70,0,24,2,46,67,1,0,5,70,51,74,47,26,95
02M625,2011,150,62,61,0,32,3,54,88,4,1,0,88,62,107,43,33,117
02M625,2010,296,150,144,2,47,7,96,186,5,1,1,168,128,205,91,53,243
02M625,2009,419,236,226,3,66,18,109,277,13,1,1,213,206,419,0,63,356
02M625,2008,423,224,208,0,80,15,145,251,12,0,0,203,220,420,3,85,338
02M625,2007,401,213,178,1,89,6,146,239,10,0,0,208,193,385,16,74,327
02M625,2006,407,202,111,6,102,6,139,253,7,1,1,211,196,377,30,79,328
02M625,2005,366,157,82,3,99,5,138,216,7,0,0,151,215,288,78,79,287
02M625,2004,373,122,82,5,113,7,128,225,11,2,0,159,214,290,83,79,294
02M625,2003,346,106,71,1,109,8,117,217,4,0,0,131,215,265,81,62,284
02M625,2002,417,145,83,5,138,9,139,252,15,2,0,146,271,292,125,60,357
02M625,2001,422,133,49,0,124,7,152,254,9,0,0,140,282,257,165,68,354
02M630,2017,328,299,299,194,9,23,43,194,48,2,18,227,101,199,129,70,258
02M630,2016,359,331,329,246,2,35,56,198,52,4,14,240,119,197,162,79,280
02M630,2015,324,286,273,109,6,21,53,181,54,1,14,193,131,201,123,62,262
02M630,2014,366,320,301,79,13,20,75,208,46,1,16,216,150,241,125,76,290
02M630,2013,326,264,258,47,16,27,80,181,34,3,1,184,142,231,95,63,263
02M630,2012,354,271,268,52,12,43,80,188,38,3,2,206,148,226,128,46,308
02M630,2011,312,247,240,50,10,26,80,167,37,1,1,191,121,205,107,40,272
02M630,2010,273,205,200,27,12,30,62,139,38,2,2,141,132,184,89,38,235
02M630,2009,312,245,239,20,10,18,96,155,43,0,0,173,139,204,108,26,286
02M630,2008,331,256,249,36,11,32,87,177,34,1,0,154,177,199,132,34,297
02M630,2007,274,201,184,36,17,20,79,141,34,0,0,143,131,178,96,31,243
02M630,2006,320,216,191,26,22,24,87,186,23,0,0,157,163,210,110,38,282
02M630,2005,307,199,158,17,11,10,87,173,31,1,5,142,165,168,139,26,281
02M630,2004,268,183,125,19,15,19,72,137,38,2,0,121,147,151,117,30,238
02M630,2003,316,193,119,34,20,21,90,149,37,3,16,116,200,156,160,36,280
02M630,2002,245,156,94,18,8,15,80,121,29,0,0,92,153,115,130,11,234
02M630,2001,280,198,91,26,11,14,87,127,51,1,0,99,181,138,142,43,237
02M655,2017,134,112,112,0,5,14,33,81,3,1,2,75,59,103,31,27,107
02M655,2016,132,104,103,2,9,10,32,84,6,0,0,74,58,107,25,17,115
02M655,2015,97,68,58,1,5,6,27,58,5,1,0,51,46,76,21,20,77
02M655,2014,119,86,69,2,6,6,43,62,3,0,5,57,62,89,30,30,89
02M655,2013,126,61,52,3,7,6,32,82,2,2,2,59,67,88,38,29,97
02M655,2012,129,80,78,8,13,6,35,79,5,1,3,59,70,87,42,17,112
02M655,2011,153,123,119,23,12,3,49,94,6,0,1,93,60,103,50,27,126
02M655,2010,145,105,93,14,11,8,39,88,7,3,0,67,78,112,33,25,120
02M655,2009,130,81,77,8,12,5,45,76,2,2,0,64,66,91,39,21,109
02M655,2008,118,78,73,11,19,3,41,69,4,1,0,55,63,91,27,28,90
02M655,2007,113,82,66,10,11,2,36,74,0,1,0,55,58,92,21,17,96
02M655,2006,118,94,71,3,7,2,40,73,3,0,0,57,61,87,31,21,97
02M655,2005,111,94,59,2,6,3,34,70,2,2,0,69,42,82,29,10,101
02M655,2004,130,108,70,20,11,8,48,70,3,0,1,79,51,98,32,13,117
02M655,2003,105,80,42,7,7,8,38,53,3,0,3,57,48,63,42,13,92
02M655,2002,136,104,51,8,7,12,61,55,6,1,1,73,63,89,47,5,131
02M655,2001,119,84,43,8,14,4,45,63,7,0,0,69,50,62,57,6,113
02M690,2006,46,23,9,0,10,2,15,25,3,1,0,24,22,32,14,9,37
02M690,2005,62,23,5,0,4,6,19,33,4,0,0,27,35,47,15,12,50
02M690,2004,64,24,10,0,17,4,21,35,4,0,0,28,36,47,17,13,51
02M690,2003,41,14,8,0,11,3,18,16,3,0,1,22,19,28,13,8,33
02M690,2002,31,14,9,0,10,1,12,14,3,1,0,14,17,19,12,0,31
02M690,2001,47,23,10,0,12,10,15,18,4,0,0,22,25,31,16,9,38
03M283,2011,65,32,24,0,13,1,23,39,2,0,0,43,22,57,8,19,46
03M283,2010,57,22,22,1,11,2,26,28,1,0,0,32,25,44,13,10,47
03M283,2009,68,32,28,1,14,3,41,29,1,0,0,50,18,57,11,9,59
03M283,2008,74,32,31,0,9,1,43,46,1,0,0,46,28,41,33,11,63
03M283,2007,91,25,15,0,17,1,21,32,2,0,0,53,38,54,37,13,78
03M283,2006,74,41,17,0,6,1,1,0,0,0,0,42,32,42,32,13,61
03M283,2005,48,44,18,0,1,0,27,40,1,0,0,32,16,27,21,5,43
03M283,2004,56,28,8,1,9,0,47,25,0,2,0,39,17,35,21,7,49
03M299,2017,91,66,66,1,8,3,38,41,7,0,2,48,43,80,11,24,67
03M299,2016,102,67,57,2,13,3,33,60,3,2,1,52,50,83,19,28,74
03M299,2015,110,79,70,1,11,2,45,61,1,0,1,66,44,87,23,19,91
03M299,2014,91,52,47,3,11,1,39,57,3,0,1,44,47,72,19,22,69
03M299,2013,106,71,67,2,11,1,46,46,2,0,0,52,54,72,34,23,83
03M299,2012,101,65,60,0,17,1,48,64,1,0,0,48,53,76,25,34,67
03M299,2011,96,71,68,0,7,2,25,51,2,2,0,44,52,79,17,18,78
03M299,2010,95,63,51,0,13,4,37,42,2,1,1,43,52,73,22,16,79
03M299,2009,114,71,60,1,11,1,39,46,2,1,0,50,64,90,24,25,89
03M299,2008,82,46,44,1,8,2,42,52,3,0,0,34,48,54,28,13,69
03M299,2007,87,42,28,1,17,0,33,52,1,2,3,33,54,55,32,18,69
03M299,2006,89,55,49,1,7,0,42,61,2,1,0,34,55,57,32,8,81
03M299,2005,99,45,37,0,11,0,34,60,1,1,0,40,59,63,36,11,88
03M307,2017,98,85,85,0,2,2,25,67,1,2,1,45,53,83,15,13,85
03M307,2016,92,85,85,0,0,2,26,56,5,0,3,50,42,73,19,11,81
03M307,2015,108,88,70,0,10,6,45,53,2,1,1,52,56,91,17,21,87
03M307,2014,106,80,64,0,14,1,42,51,0,2,0,58,48,84,22,21,85
03M307,2013,96,74,57,0,14,3,34,49,5,2,1,52,44,77,19,26,70
03M307,2012,94,66,55,0,13,2,37,54,2,1,0,55,39,63,31,24,70
03M307,2011,96,70,59,0,14,2,22,43,4,2,0,44,52,72,24,17,79
03M307,2010,73,48,38,0,12,1,28,53,2,1,1,30,43,47,26,16,57
03M307,2009,86,43,35,2,16,3,32,41,4,2,0,31,55,63,23,12,74
03M307,2008,82,53,45,2,10,1,39,54,0,1,0,36,46,59,23,19,63
03M307,2007,95,68,48,2,13,2,37,45,6,2,0,47,48,67,28,18,77
03M307,2006,100,60,43,0,19,3,26,41,8,0,1,32,68,66,34,19,81
03M307,2005,92,62,31,0,6,0,44,58,2,0,2,46,46,69,23,8,84
03M307,2004,79,47,33,0,5,0,39,54,6,1,0,39,40,52,27,6,73
03M402,2017,75,71,71,19,3,4,20,46,4,0,1,25,50,67,8,18,57
03M402,2016,69,64,60,6,3,1,27,46,7,1,1,38,31,49,20,15,54
03M402,2015,83,61,39,3,10,2,24,53,6,0,0,35,48,74,9,24,59
03M402,2014,85,64,41,0,4,2,25,56,2,2,0,45,40,78,7,22,63
03M402,2013,87,69,51,0,9,1,12,64,1,0,0,31,56,77,10,29,58
03M402,2012,88,50,39,0,18,2,16,47,2,0,0,39,49,83,5,30,58
03M402,2011,78,50,37,0,10,1,20,77,0,0,0,32,46,72,6,22,56
03M402,2010,67,26,16,0,16,0,17,45,3,0,4,28,39,61,6,18,49
03M402,2009,98,32,26,0,10,0,23,63,1,0,1,48,50,81,17,21,77
03M403,2017,113,100,100,39,4,5,23,82,2,0,1,47,66,94,19,25,88
03M403,2016,97,75,74,23,4,2,23,67,4,2,1,51,46,78,19,18,79
03M403,2015,99,71,63,5,8,1,26,75,3,0,1,49,50,83,16,14,85
03M403,2014,106,80,70,4,11,2,23,74,6,0,0,49,57,87,19,22,84
03M403,2013,105,73,57,8,5,6,42,73,8,0,0,43,62,80,25,23,82
03M403,2012,100,79,72,13,8,2,22,63,5,0,0,49,51,80,20,26,74
03M403,2011,129,96,83,11,14,0,28,63,5,0,1,67,62,110,19,33,96
03M403,2010,92,61,55,5,10,0,31,63,5,0,1,39,53,85,7,10,82
03M403,2009,89,44,40,1,16,0,25,61,3,0,0,45,44,83,6,15,74
03M404,2017,51,7,6,0,2,2,23,44,2,0,0,24,27,46,5,8,43
03M404,2016,71,6,6,0,4,2,35,63,2,0,0,34,37,67,4,8,63
03M404,2015,96,10,10,0,8,1,31,57,4,0,0,45,51,77,19,17,79
03M404,2014,102,16,14,0,3,3,18,62,1,0,0,55,47,90,12,10,92
03M404,2013,87,8,8,0,8,1,20,63,1,0,0,51,36,71,16,12,75
03M404,2012,69,9,8,0,5,35,34,24,1,0,0,27,42,53,16,9,60
03M404,2011,93,3,3,0,3,65,39,23,4,0,0,48,45,70,23,13,80
03M404,2010,84,11,10,0,7,0,15,34,2,0,0,43,41,75,9,8,76
03M404,2009,85,7,7,0,10,0,31,61,4,0,0,40,45,68,17,6,79
03M404,2008,94,10,10,0,24,0,31,55,1,0,0,53,41,70,24,11,83
03M404,2007,131,29,24,0,14,0,20,46,0,3,0,71,60,131,0,12,119
03M404,2006,39,11,8,0,2,0,13,26,0,0,0,23,16,39,0,3,36
03M415,2017,46,46,46,20,0,1,27,12,3,0,1,33,13,34,12,10,36
03M415,2016,42,40,40,13,2,1,34,44,1,0,0,25,17,31,11,8,34
03M415,2015,47,40,31,1,2,4,39,42,1,2,0,36,11,35,12,10,37
03M415,2014,44,36,29,0,6,1,63,47,2,0,0,26,18,30,14,10,34
03M415,2013,80,58,51,0,8,1,56,36,0,0,0,55,25,48,32,17,63
03M415,2012,88,59,53,1,10,1,57,32,1,0,0,61,27,63,25,17,71
03M415,2011,113,64,58,1,7,1,55,25,2,0,0,81,32,73,40,24,89
03M415,2010,93,43,40,3,16,1,87,32,1,1,0,56,37,72,21,25,68
03M415,2009,91,36,34,2,9,1,79,47,0,1,0,48,43,91,0,17,74
03M415,2008,83,34,32,1,16,1,98,60,0,0,0,52,31,83,0,17,66
03M415,2007,122,73,62,7,16,3,95,56,0,0,0,69,53,120,2,19,103
03M415,2006,127,71,60,19,2,1,77,43,2,0,0,75,52,127,0,23,104
03M415,2005,128,90,67,14,1,1,70,31,2,1,0,63,65,128,0,17,111
03M415,2004,159,97,59,7,2,0,25,18,1,1,1,69,90,157,2,31,128
03M415,2003,154,97,70,11,9,0,27,12,2,0,1,78,76,134,20,30,124
03M415,2002,123,81,64,2,15,0,28,19,0,0,0,69,54,54,69,15,108
03M415,2001,105,63,43,3,15,0,82,44,0,1,0,49,56,74,31,15,90
03M417,2017,103,100,100,2,0,6,13,48,25,2,9,56,47,51,52,14,89
03M417,2016,101,92,92,1,2,4,13,49,33,0,2,56,45,58,43,25,76
03M417,2015,95,88,82,3,0,3,21,42,25,0,4,41,54,59,36,13,82
03M417,2014,94,88,85,4,0,4,16,43,27,0,4,60,34,59,35,17,77
03M417,2013,87,83,76,11,1,9,17,38,20,0,3,51,36,51,36,20,67
03M417,2012,77,69,66,4,0,8,11,30,23,1,4,46,31,33,44,10,67
03M417,2011,102,92,86,7,2,9,16,37,40,0,0,54,48,43,59,17,85
03M417,2010,73,67,65,6,0,5,13,35,20,0,0,39,34,33,40,13,60
03M470,2008,293,114,106,22,99,5,81,203,4,0,0,143,150,222,71,47,246
03M470,2007,452,145,96,18,140,7,115,323,5,2,0,222,230,427,25,57,395
03M470,2006,521,185,112,22,120,11,116,386,4,4,0,271,250,493,28,64,457
03M470,2005,580,205,120,32,105,11,166,394,8,1,0,291,289,552,28,83,497
03M470,2004,568,184,104,17,146,5,150,407,5,1,0,300,268,407,161,71,497
03M470,2003,601,229,148,33,155,16,220,356,7,2,0,318,283,429,172,53,548
03M470,2002,496,216,144,27,104,12,182,283,15,4,0,276,220,430,66,30,466
03M470,2001,450,159,99,24,127,6,152,279,11,2,0,230,220,396,54,78,372
03M479,2017,382,368,368,0,3,34,57,81,155,7,48,234,148,112,270,31,351
03M479,2016,349,338,338,0,2,35,54,59,178,1,22,222,127,79,270,36,313
03M479,2015,306,300,300,0,1,19,38,51,165,2,31,194,112,85,221,28,278
03M479,2014,319,311,311,0,0,28,45,62,179,1,4,204,115,77,242,17,302
03M479,2013,283,282,282,0,0,20,41,76,142,1,3,196,87,88,195,14,269
03M479,2012,363,357,357,0,0,30,50,88,187,4,4,235,128,100,263,27,336
03M479,2011,297,295,295,0,0,33,42,70,148,2,2,187,110,77,220,3,294
03M479,2010,304,298,298,0,0,30,54,74,144,1,1,167,137,90,214,19,285
03M479,2009,262,255,255,0,0,18,37,59,147,1,0,163,99,61,201,12,250
03M479,2008,279,270,270,0,2,22,38,65,153,0,1,181,98,53,226,11,268
03M479,2007,284,277,250,0,3,23,46,63,150,1,1,166,118,68,216,17,267
03M479,2006,269,259,247,0,0,15,33,57,155,0,9,157,112,58,211,15,254
03M479,2005,246,234,199,0,1,13,45,47,141,0,0,158,88,43,203,7,239
03M479,2004,227,194,169,0,4,11,53,58,103,2,0,123,104,50,177,17,210
03M479,2003,230,200,140,0,5,16,45,50,118,1,0,130,100,53,177,13,217
03M479,2002,230,200,160,0,7,22,44,50,114,0,0,128,102,55,175,7,223
03M479,2001,226,202,198,0,6,14,42,68,101,1,0,124,102,65,161,6,220
03M485,2017,768,752,752,689,2,154,77,141,361,3,32,581,187,223,545,34,734
03M485,2016,636,632,632,588,3,133,66,108,284,2,43,488,148,197,439,20,616
03M485,2015,716,706,705,574,1,137,80,135,314,1,49,543,173,249,467,16,700
03M485,2014,609,592,592,466,4,128,62,108,280,1,30,446,163,200,409,10,599
03M485,2013,643,618,617,392,3,112,84,137,269,0,41,465,178,212,431,23,620
03M485,2012,660,640,640,444,2,136,81,129,286,1,27,471,189,235,425,18,642
03M485,2011,662,645,645,470,1,128,64,124,328,5,13,491,171,182,480,17,645
03M485,2010,675,657,657,466,0,144,80,109,333,0,9,493,182,216,459,11,664
03M485,2009,663,634,634,451,0,133,108,114,300,3,5,485,178,237,426,10,653
03M485,2008,553,548,548,402,2,101,77,92,277,2,4,404,149,171,382,8,545
03M485,2007,601,586,583,468,3,120,96,122,260,2,1,446,155,192,409,5,596
03M485,2006,646,627,621,324,6,135,110,113,288,0,0,512,134,187,459,6,640
03M485,2005,655,631,622,414,3,127,114,122,291,1,0,483,172,210,445,8,647
03M485,2004,614,586,579,385,2,105,92,128,288,1,0,439,175,182,432,5,609
03M485,2003,535,519,503,437,1,93,96,116,230,0,0,384,151,164,371,2,533
03M485,2002,563,530,524,230,1,102,102,90,269,0,0,392,171,138,425,6,557
03M485,2001,592,519,487,243,4,115,107,115,254,1,0,388,204,129,463,2,590
03M490,2001,227,160,0,0,55,0,1,0,0,0,0,0,1,195,32,1,0
03M492,2017,83,61,60,14,5,5,20,53,4,1,0,40,43,72,11,18,65
03M492,2016,106,95,95,18,7,3,40,58,4,1,0,61,45,93,13,9,97
03M492,2015,109,79,66,15,16,2,44,61,1,0,1,62,47,97,12,23,86
03M492,2014,117,84,76,12,15,4,39,72,2,0,0,68,49,106,11,20,97
03M492,2013,109,76,69,5,13,1,46,59,3,0,0,47,62,94,15,16,93
03M492,2012,106,83,76,5,11,1,59,43,3,0,0,59,47,94,12,17,89
03M492,2011,112,78,75,5,15,4,41,62,1,4,0,67,45,100,12,16,96
03M492,2010,115,78,70,4,16,2,47,60,3,3,0,64,51,95,20,20,95
03M492,2009,123,84,80,16,9,1,61,36,3,2,0,78,45,106,17,16,107
03M492,2008,103,70,65,10,10,1,56,41,2,2,0,62,41,80,23,16,87
03M492,2007,102,71,66,24,11,4,47,53,3,0,0,63,39,81,21,14,88
03M492,2006,107,81,66,16,10,4,44,54,2,0,2,66,41,81,26,26,81
03M492,2005,98,71,51,3,7,1,63,45,2,2,0,48,50,75,23,18,80
03M492,2004,106,61,37,5,21,3,70,36,2,0,0,59,47,76,30,25,81
03M492,2003,113,56,30,2,16,0,64,52,2,5,0,65,48,72,41,10,103
03M492,2002,111,67,36,0,17,0,37,59,1,1,0,75,36,96,15,4,107
03M494,2017,99,82,82,10,7,6,34,56,0,0,3,33,66,74,25,20,79
03M494,2016,111,86,86,9,12,6,42,58,3,1,1,42,69,94,17,31,80
03M494,2015,116,74,61,5,18,5,38,67,4,2,0,42,74,100,16,32,84
03M494,2014,121,63,49,3,14,3,43,72,2,1,0,38,83,106,15,29,92
03M494,2013,131,92,67,1,11,5,48,72,3,2,1,44,87,121,10,27,104
03M494,2012,129,80,58,1,20,2,46,77,3,0,1,47,82,112,17,26,103
03M494,2011,151,96,75,3,17,8,44,93,5,1,0,52,99,136,15,37,114
03M494,2010,137,82,71,5,18,7,42,85,1,2,0,43,94,124,13,24,113
03M494,2009,145,87,85,4,16,7,56,79,3,0,0,47,98,126,19,20,125
03M494,2008,135,89,87,1,16,6,48,77,3,1,0,43,92,118,17,20,115
03M494,2007,142,101,85,2,13,10,52,75,4,0,1,45,97,113,29,19,123
03M494,2006,137,86,67,4,9,1,55,75,5,0,1,47,90,109,28,33,104
03M494,2005,152,106,84,11,9,8,62,81,1,0,0,62,90,118,34,23,129
03M494,2004,155,92,62,10,31,6,47,97,5,0,0,47,108,117,38,22,133
03M494,2003,151,74,41,1,32,2,67,80,2,0,0,53,98,117,34,25,126
03M494,2002,165,108,72,1,9,4,91,66,3,1,0,76,89,152,13,9,156
03M505,2017,85,10,10,0,29,1,52,114,4,1,2,39,46,78,7,40,45
03M505,2016,165,24,15,1,11,3,34,137,10,0,1,83,82,146,19,69,96
03M505,2015,174,26,21,0,29,1,35,123,4,1,1,90,84,157,17,61,113
03M505,2014,167,16,12,0,37,3,49,148,3,1,0,70,97,160,7,43,124
03M505,2013,185,33,27,0,28,4,61,119,3,1,1,98,87,161,24,44,141
03M505,2012,165,24,19,0,24,1,78,161,3,2,1,85,80,153,12,54,111
03M505,2011,204,33,22,0,20,1,74,188,2,0,0,96,108,182,22,51,153
03M505,2010,189,36,34,0,18,2,83,149,3,1,0,116,73,166,23,44,145
03M505,2009,246,39,31,1,36,3,70,151,3,0,0,124,122,215,31,35,211
03M505,2008,265,55,50,1,39,1,61,132,3,0,0,152,113,265,0,48,217
03M505,2007,238,59,42,1,31,2,112,143,7,1,1,146,92,236,2,47,191
03M505,2006,200,55,32,1,13,5,112,180,14,1,0,117,83,197,3,45,155
03M505,2005,227,57,14,0,35,0,28,54,0,3,0,143,84,189,38,48,179
03M505,2004,197,48,7,0,33,0,60,104,1,0,0,108,89,167,30,48,149
03M505,2003,290,35,5,0,61,0,43,118,5,1,0,135,155,220,70,54,236
03M505,2002,266,32,3,0,30,0,69,126,2,2,1,158,108,220,46,42,224
03M505,2001,312,52,5,0,43,0,118,169,2,0,1,160,152,235,77,64,248
03M541,2017,110,107,107,4,0,35,16,30,26,0,3,66,44,67,43,15,95
03M541,2016,111,110,110,0,0,27,24,36,21,0,3,66,45,73,38,15,96
03M541,2015,100,99,98,9,0,26,13,35,21,1,4,56,44,62,38,14,86
03M541,2014,113,109,108,46,1,35,16,39,17,2,4,60,53,65,48,14,99
03M541,2013,122,122,120,42,0,31,17,51,15,1,7,73,49,77,45,11,111
03M541,2012,97,96,95,29,0,20,17,35,16,2,7,54,43,52,45,9,88
03M541,2011,107,106,106,18,0,31,23,36,13,1,3,69,38,62,45,2,105
03M541,2010,118,115,115,23,0,21,27,54,15,1,0,67,51,78,40,5,113
03M541,2009,117,106,106,29,0,26,22,57,10,2,0,62,55,87,30,7,110
03M541,2008,109,104,104,24,2,40,24,36,9,0,0,73,36,64,45,4,105
03M541,2007,112,97,91,26,3,31,21,42,18,0,0,50,62,69,43,5,107
03M541,2006,90,84,84,47,1,25,20,33,11,1,0,43,47,52,38,2,88
03M541,2005,102,94,89,22,1,28,24,43,6,0,1,63,39,49,53,2,100
03M541,2004,117,109,104,41,1,36,24,32,23,2,0,63,54,60,57,1,116
03M541,2003,84,75,75,24,4,16,20,35,13,0,0,46,38,62,22,2,82
03M859,2017,45,45,45,31,0,1,5,6,26,2,5,20,25,16,29,7,38
03M859,2016,47,47,47,23,0,8,5,6,17,1,10,25,22,11,36,5,42
03M859,2015,42,39,38,0,1,5,4,8,17,0,8,20,22,16,26,8,34
03M859,2014,45,44,44,10,0,9,10,10,13,0,3,24,21,14,31,4,41
03M859,2013,51,50,49,1,1,10,10,5,17,0,9,23,28,12,39,13,38
03M860,2017,64,56,56,13,4,1,40,21,2,0,0,27,37,54,10,12,52
03M860,2016,73,63,63,4,2,2,39,27,3,0,2,24,49,61,12,14,59
03M860,2015,76,52,43,0,7,4,47,23,1,0,1,28,48,62,14,18,58
03M860,2014,74,53,43,0,9,2,51,19,1,0,1,30,44,58,16,13,61
03M860,2013,76,52,34,1,10,3,47,16,1,2,0,31,45,54,22,26,50
03M860,2012,58,31,19,1,5,1,45,12,1,0,0,29,29,38,20,11,47
03M860,2011,69,35,29,1,5,1,50,10,0,0,0,21,48,47,22,11,58
03M860,2010,59,40,28,0,3,1,43,10,0,0,0,31,28,44,15,11,48
03M860,2009,76,46,41,2,11,0,46,26,0,1,3,37,39,56,20,20,56
03M860,2008,61,38,32,1,8,0,43,15,0,0,0,24,37,42,19,12,49
03M860,2007,64,42,38,2,4,0,56,19,1,0,0,27,37,44,20,15,49
03M860,2006,54,40,31,9,7,0,49,14,1,0,0,26,28,26,28,11,43
03M860,2005,69,38,32,7,0,0,52,17,0,0,0,33,36,50,19,5,64
03M860,2004,67,48,39,12,5,0,60,7,0,0,0,40,27,35,32,4,63
03M860,2003,27,21,16,5,1,0,24,3,0,0,0,13,14,19,8,0,27
04M310,2017,64,18,17,0,4,9,24,24,2,3,2,28,36,54,10,23,41
04M310,2016,78,35,29,0,11,9,36,30,1,2,0,28,50,60,18,29,49
04M372,2017,85,69,69,34,4,1,9,84,0,0,0,35,50,79,6,16,69
04M372,2016,86,70,70,32,6,1,9,72,2,0,0,40,46,78,8,15,71
04M372,2015,94,68,59,6,7,2,16,51,1,0,0,53,41,82,12,17,77
04M372,2014,84,55,50,1,6,0,6,77,2,0,0,40,44,73,11,16,68
04M372,2013,80,58,48,4,6,0,7,77,2,0,0,34,46,64,16,14,66
04M372,2012,70,47,40,1,3,0,6,73,0,1,0,32,38,59,11,15,55
04M409,2014,40,32,22,0,5,3,30,22,1,0,0,20,20,39,1,16,24
04M409,2013,56,38,26,0,11,3,27,40,3,1,1,24,32,44,12,16,40
04M409,2012,75,35,24,0,21,2,41,42,0,0,0,34,41,51,24,22,53
04M409,2011,83,27,20,0,19,3,43,60,2,2,0,48,35,58,25,29,54
04M409,2010,85,22,20,0,20,2,20,53,0,1,0,45,40,65,20,29,56
04M409,2009,94,40,35,0,25,3,26,53,0,1,0,54,40,94,0,14,80
04M409,2008,110,50,45,0,26,2,32,53,3,0,0,65,45,110,0,21,89
04M409,2007,106,51,29,0,28,2,26,49,9,0,0,60,46,97,9,20,86
04M409,2006,76,50,30,1,10,3,25,43,6,1,0,41,35,76,0,24,52
04M409,2005,83,63,12,0,9,0,39,43,1,0,0,48,35,82,1,13,70
04M409,2004,75,38,11,0,15,0,27,64,3,0,0,39,36,74,1,11,64
04M409,2003,90,51,20,0,13,0,33,73,0,0,0,50,40,84,6,12,78
04M409,2002,86,46,22,0,21,0,24,50,1,0,0,54,32,42,44,9,77
04M409,2001,78,44,13,0,10,0,0,1,0,0,0,40,38,49,29,10,68
04M435,2017,429,416,416,315,2,98,84,221,20,5,1,220,209,359,70,52,377
04M435,2016,413,386,386,323,3,92,63,224,26,6,2,200,213,351,62,46,367
04M435,2015,378,360,348,224,2,72,74,209,21,0,2,199,179,314,64,44,334
04M435,2014,381,362,353,257,1,79,77,190,25,3,7,188,193,322,59,17,364
04M435,2013,403,382,376,239,1,67,101,212,14,3,6,191,212,340,63,23,380
04M435,2012,380,355,351,204,1,72,64,221,17,2,4,186,194,324,56,33,347
04M435,2011,361,330,329,188,1,85,75,185,16,0,0,184,177,282,79,10,351
04M435,2010,393,344,341,205,8,89,67,230,6,0,1,204,189,325,68,17,376
04M435,2009,444,388,379,178,10,76,95,263,6,4,0,253,191,345,99,31,413
04M435,2008,408,358,355,204,8,87,87,218,12,4,0,227,181,322,86,22,386
04M435,2007,388,344,335,212,3,90,89,200,9,0,0,203,185,314,74,30,358
04M435,2006,381,334,320,209,5,71,71,222,15,2,0,190,191,299,82,27,354
04M435,2005,418,361,331,232,9,82,86,234,13,2,1,205,213,295,123,50,368
04M435,2004,313,244,217,163,15,45,71,186,7,4,0,152,161,227,86,37,276
04M435,2003,306,243,228,171,22,46,71,178,8,2,1,177,129,281,25,16,290
04M435,2002,431,320,305,227,27,32,101,282,15,1,0,206,225,420,11,26,405
04M435,2001,414,275,259,175,31,44,95,259,15,1,0,218,196,405,9,48,366
04M495,2017,92,92,92,31,0,2,29,56,1,1,3,47,45,76,16,18,74
04M495,2016,94,92,90,27,1,5,19,64,2,1,3,50,44,84,10,13,81
04M495,2015,109,101,88,22,0,10,31,62,2,0,4,56,53,83,26,17,92
04M495,2014,92,89,83,27,0,2,19,67,1,1,2,45,47,81,11,10,82
04M495,2013,112,107,101,20,0,5,27,72,5,0,3,61,51,89,23,22,90
04M495,2012,93,69,66,2,3,4,31,55,1,1,1,46,47,80,13,18,75
04M495,2011,96,92,89,10,1,7,31,57,0,1,0,50,46,86,10,10,86
04M495,2010,82,70,65,9,1,3,29,50,0,0,0,43,39,76,6,11,71
04M495,2009,90,64,61,3,9,4,31,54,0,0,1,55,35,81,9,18,72
04M495,2008,77,64,62,5,8,2,22,51,2,0,0,47,30,61,16,13,64
04M495,2007,84,60,53,3,8,2,39,45,4,2,0,45,39,60,24,13,71
04M495,2006,92,53,29,5,10,1,45,55,2,0,1,56,36,75,17,21,71
04M495,2005,104,54,31,6,11,1,30,41,0,0,0,55,49,77,27,12,92
04M495,2004,72,57,29,1,3,0,37,44,1,2,0,46,26,53,19,10,62
04M495,2003,83,60,29,0,6,0,41,41,0,1,0,40,43,64,19,7,76
04M495,2002,71,45,16,3,12,0,28,42,1,0,0,42,29,50,21,10,61
04M495,2001,61,41,12,0,5,0,24,35,2,0,0,37,24,45,16,8,53
04M555,2017,130,129,129,83,1,28,33,64,5,0,0,88,42,107,23,20,110
04M555,2016,114,112,112,37,1,21,37,51,4,0,1,71,43,92,22,15,99
04M555,2015,113,111,102,28,0,12,30,63,6,2,0,66,47,92,21,18,95
04M555,2014,131,127,124,30,1,14,33,74,9,1,0,86,45,111,20,15,116
04M555,2013,112,109,106,35,1,8,25,72,5,2,0,82,30,98,14,12,100
04M555,2012,104,97,92,10,1,4,25,71,3,0,1,64,40,92,12,15,89
04M555,2011,96,93,91,26,1,4,27,62,3,0,0,63,33,84,12,11,85
04M555,2010,133,128,120,24,1,10,34,87,1,1,0,100,33,116,17,17,116
04M555,2009,87,79,75,19,2,8,26,51,1,1,0,58,29,74,13,6,81
04M555,2008,89,73,67,7,2,5,22,59,3,0,0,54,35,83,6,21,68
04M555,2007,62,49,43,1,3,1,24,35,1,0,1,32,30,61,1,9,53
04M555,2006,63,42,26,1,7,4,26,30,2,1,0,31,32,60,3,10,53
04M555,2005,72,42,23,0,5,3,30,36,3,0,0,36,36,71,1,13,59
04M555,2004,67,35,18,0,8,2,24,40,1,0,0,35,32,53,14,11,56
04M555,2003,54,27,15,0,11,2,16,35,1,0,0,29,25,40,14,11,43
04M555,2002,64,24,0,0,17,2,31,30,0,1,0,28,36,39,25,10,54
04M555,2001,74,27,4,0,15,1,27,42,3,1,0,42,32,49,25,11,63
04M610,2017,79,79,79,58,0,8,18,48,2,0,3,79,0,66,13,15,64
04M610,2016,82,81,80,62,0,8,21,46,6,0,1,82,0,64,18,12,70
04M610,2015,73,72,67,31,1,7,17,44,2,0,3,73,0,52,21,9,64
04M610,2014,86,86,80,32,0,8,18,56,2,0,2,86,0,65,21,20,66
04M610,2013,82,82,81,24,0,7,19,47,7,0,2,82,0,69,13,8,74
04M610,2012,71,71,69,20,0,9,22,37,1,0,2,71,0,51,20,10,61
04M610,2011,71,70,68,21,0,5,21,42,1,1,1,71,0,49,22,9,62
04M610,2010,65,62,57,18,0,2,27,34,2,0,0,65,0,46,19,8,57
04M610,2009,67,67,62,20,0,4,24,38,1,0,0,67,0,53,14,8,59
04M610,2008,66,66,60,14,0,1,28,35,1,1,0,66,0,53,13,7,59
04M610,2007,64,63,57,4,0,2,26,36,0,0,0,64,0,51,13,4,60
04M610,2006,55,55,47,9,0,1,13,37,2,2,0,55,0,38,17,7,48
04M610,2005,59,58,50,7,0,2,21,26,1,0,1,59,0,59,0,2,57
04M610,2004,51,48,41,8,0,1,18,33,2,0,0,51,0,51,0,5,46
04M610,2003,64,63,46,12,0,0,17,40,2,0,0,64,0,64,0,7,57
04M610,2002,54,54,42,9,0,0,26,37,0,0,1,54,0,50,4,3,51
04M610,2001,63,61,44,10,0,0,22,40,1,0,0,63,0,54,9,7,56
04M635,2010,17,14,13,0,3,1,7,9,0,0,0,6,11,13,4,3,14
04M635,2009,52,22,20,0,9,3,17,28,4,0,0,21,31,38,14,9,43
04M635,2008,100,42,40,0,11,4,28,67,0,1,0,40,60,71,29,21,79
04M635,2007,98,42,21,0,23,3,31,63,0,1,0,53,45,62,36,15,83
04M635,2006,75,31,18,1,15,1,23,43,1,0,0,28,47,59,16,16,59
04M635,2005,85,42,17,1,10,2,23,30,0,0,0,35,50,49,36,12,73
04M635,2004,89,43,18,0,17,0,23,51,1,0,0,49,40,58,31,3,86
04M635,2003,68,38,20,4,5,0,27,58,0,0,0,27,41,46,22,9,59
04M635,2002,41,28,13,1,5,0,27,61,1,0,0,22,19,28,13,3,38
04M635,2001,55,29,3,0,7,0,10,31,0,0,0,25,30,37,18,1,54
04M680,2017,68,51,50,9,11,2,21,41,2,0,2,28,40,56,12,13,55
04M680,2016,65,55,55,12,3,4,17,39,4,0,1,29,36,62,3,21,44
04M680,2015,71,64,55,2,3,2,19,43,4,0,3,35,36,61,10,17,54
04M680,2014,51,40,33,5,5,2,21,41,2,0,0,24,27,50,1,12,39
04M680,2013,66,42,36,2,8,1,31,50,1,0,1,31,35,57,9,19,47
04M680,2012,84,59,48,2,12,1,25,55,1,0,0,52,32,75,9,27,57
04M680,2011,81,48,41,2,14,1,20,44,0,1,0,45,36,70,11,27,54
04M680,2010,82,53,47,4,6,1,17,56,3,0,0,37,45,77,5,27,55
04M680,2009,66,37,36,2,5,2,30,42,1,0,0,39,27,51,15,10,56
04M680,2008,58,35,32,0,10,1,25,45,1,0,0,21,37,49,9,16,42
04M680,2007,77,1,1,0,8,0,16,34,1,0,0,35,42,61,16,20,57
04M680,2006,75,42,26,2,7,0,29,51,0,1,0,34,41,58,17,21,54
04M680,2005,84,46,28,3,7,0,13,43,2,0,0,49,35,70,14,17,67
04M680,2004,59,34,18,4,7,0,27,56,1,0,0,33,26,40,19,10,49
04M680,2003,60,31,22,6,11,0,17,40,1,1,0,33,27,44,16,13,47
04M680,2002,72,51,39,11,7,0,22,38,0,0,0,43,29,66,6,5,67
04M680,2001,52,29,14,0,7,0,26,26,0,0,0,32,20,47,5,4,48
04M695,2006,45,35,27,5,5,1,33,22,1,0,0,34,11,40,5,7,38
04M695,2005,57,31,17,1,11,1,24,18,0,0,1,31,26,45,12,9,48
04M695,2004,44,26,11,0,7,0,22,22,0,1,0,27,17,29,15,7,37
04M695,2003,53,20,9,0,5,0,39,14,0,0,0,23,30,23,30,12,41
04M695,2002,74,30,17,0,14,0,36,35,3,0,0,32,42,37,37,8,66
04M695,2001,58,13,0,0,16,0,35,23,0,0,0,29,29,39,19,11,47
05M148,2017,47,32,32,17,2,0,32,14,0,0,1,0,47,32,15,17,30
05M148,2016,67,49,49,10,4,0,50,14,0,2,1,0,67,47,20,15,52
05M157,2017,59,45,45,0,3,1,28,26,3,0,1,33,26,51,8,21,38
05M157,2016,59,41,41,0,3,1,27,30,0,0,1,28,31,47,12,16,43
05M157,2015,48,32,27,0,9,1,22,24,1,0,0,20,28,39,9,8,40
05M157,2014,77,42,35,0,6,1,33,39,2,0,2,39,38,62,15,17,60
05M157,2013,64,43,30,0,6,1,32,29,0,1,1,25,39,55,9,20,44
05M285,2017,87,13,13,0,13,1,33,50,3,0,0,42,45,75,12,24,63
05M285,2016,119,23,17,0,17,1,56,55,5,1,1,54,65,97,22,39,80
05M285,2015,111,13,12,0,23,3,48,55,3,2,0,67,44,99,12,21,90
05M285,2014,94,12,11,0,29,2,51,39,1,1,0,49,45,87,7,26,68
05M285,2013,95,7,6,0,4,2,40,51,2,0,0,60,35,85,10,26,69
05M285,2012,105,11,8,0,25,4,44,53,2,2,0,67,38,74,31,20,85
05M285,2011,83,19,17,0,7,1,59,47,1,0,0,52,31,68,15,16,67
05M285,2010,108,25,20,0,14,1,59,44,1,0,0,64,44,83,25,17,91
05M285,2009,105,16,11,0,27,1,40,30,0,0,0,63,42,88,17,16,89
05M285,2008,102,21,19,0,16,0,39,43,1,0,0,66,36,78,24,14,88
05M285,2007,89,16,12,0,15,0,54,48,0,0,0,58,31,69,20,13,76
05M285,2006,81,10,5,0,18,0,49,39,1,0,0,47,34,58,23,11,70
05M285,2005,85,7,1,0,24,0,52,28,0,1,0,47,38,67,18,10,75
05M285,2004,77,3,1,0,22,0,54,27,2,1,1,40,37,61,16,6,71
05M285,2003,71,4,0,0,28,0,46,31,0,0,0,49,22,48,23,5,66
05M285,2002,48,1,0,0,11,0,27,21,0,0,0,21,27,34,14,6,42
05M304,2017,46,37,37,0,1,2,21,21,2,0,0,22,24,43,3,14,32
05M304,2016,70,44,35,0,10,2,24,40,2,2,0,31,39,66,4,26,44
05M304,2015,75,47,44,0,6,3,23,47,1,1,0,39,36,69,6,12,63
05M304,2014,82,51,38,0,8,1,27,49,3,0,2,34,48,78,4,26,56
05M304,2013,94,60,51,0,8,1,30,61,1,0,2,41,53,84,10,25,69
05M304,2012,95,68,47,0,5,1,44,57,0,0,0,36,59,82,13,17,78
05M304,2011,102,68,54,3,7,1,37,62,1,0,0,41,61,92,10,22,80
05M304,2010,101,64,59,0,6,1,25,72,1,0,0,42,59,87,14,18,83
05M304,2009,99,65,64,7,9,1,31,59,0,0,0,46,53,90,9,7,92
05M304,2008,91,53,49,5,3,1,29,60,2,0,0,54,37,80,11,12,79
05M304,2007,93,62,52,0,7,3,23,55,4,0,0,46,47,72,21,15,78
05M304,2006,96,67,63,8,7,0,30,64,0,0,0,50,46,70,26,16,80
05M304,2005,92,69,67,2,7,0,41,49,3,0,0,38,54,60,32,8,84
05M304,2004,85,55,53,3,3,0,30,63,3,0,0,47,38,65,20,1,84
05M362,2017,94,91,91,70,1,7,19,37,27,0,4,40,54,37,57,9,85
05M362,2016,95,89,85,46,0,10,20,35,28,2,0,55,40,52,43,10,85
05M362,2015,100,96,92,62,0,11,18,44,25,0,2,52,48,57,43,8,92
05M362,2014,90,88,85,21,0,10,21,43,15,0,1,44,46,61,29,5,85
05M362,2013,92,89,88,70,0,16,10,49,16,1,0,52,40,54,38,2,90
05M362,2012,82,80,80,36,0,12,20,38,12,0,0,38,44,54,28,1,81
05M362,2011,85,84,83,43,0,15,18,41,8,1,2,45,40,50,35,2,83
05M362,2010,93,91,91,43,0,11,13,54,14,1,0,53,40,61,32,2,91
05M367,2014,27,9,6,0,6,2,24,25,4,0,1,12,26,25,2,7,20
05M367,2013,38,13,4,0,7,1,31,21,0,0,0,35,21,27,11,13,25
05M367,2012,56,22,22,1,12,0,2,0,0,0,0,24,24,40,16,14,42
05M367,2011,48,28,17,0,2,0,12,14,1,0,0,31,38,41,7,8,40
05M367,2010,69,28,22,0,1,0,28,20,0,0,0,37,34,55,14,16,53
05M367,2009,71,40,37,7,0,0,40,29,0,0,0,25,27,57,14,14,57
05M367,2008,52,16,16,0,3,0,38,33,0,0,0,33,20,31,21,15,37
05M367,2007,53,42,29,1,1,0,30,22,0,0,0,0,2,42,11,6,47
05M369,2017,97,78,78,25,13,2,49,42,1,0,3,74,23,76,21,20,77
05M369,2016,69,53,53,1,4,1,38,29,1,0,1,59,10,58,11,18,51
05M369,2015,73,55,45,0,13,1,30,28,0,1,0,55,18,57,16,20,53
05M369,2014,75,50,44,0,15,1,39,29,0,0,0,56,19,68,7,24,51
05M369,2013,70,50,46,0,9,1,33,14,2,1,0,51,19,61,9,11,59
05M369,2012,60,45,43,1,6,1,46,23,0,0,0,50,10,41,19,9,51
05M369,2011,88,68,61,0,12,0,38,29,0,1,1,66,22,70,18,16,72
05M369,2010,69,54,44,0,7,0,31,39,0,0,3,60,9,62,7,13,56
05M369,2009,62,40,34,0,10,0,46,26,1,1,1,44,18,49,13,15,47
05M369,2008,51,36,32,0,5,0,49,38,1,0,0,39,12,42,9,8,43
05M369,2007,70,47,44,0,7,0,38,22,2,0,0,56,14,52,18,5,65
05M369,2006,62,43,42,0,10,0,41,21,0,0,0,52,10,46,16,8,54
05M469,2012,31,24,17,0,5,0,24,7,0,0,0,20,11,26,5,7,24
05M469,2011,26,10,8,0,10,0,19,6,1,0,0,16,10,22,4,8,18
05M469,2010,17,9,7,0,3,0,10,7,0,0,0,11,6,16,1,5,12
05M469,2009,30,7,7,0,1,0,21,9,0,0,0,19,11,26,4,2,28
05M469,2008,44,26,26,0,0,0,38,5,0,1,0,29,15,31,13,1,43
05M469,2007,45,30,17,0,2,0,35,8,0,2,0,31,14,33,12,7,38
05M469,2006,39,22,16,0,4,0,32,6,0,1,0,26,13,32,7,4,35
05M469,2005,84,47,23,1,10,0,64,19,0,1,0,58,26,60,24,8,76
05M469,2004,58,36,17,2,3,0,47,10,1,0,0,45,13,38,20,1,57
05M469,2003,52,37,11,0,1,0,44,6,1,0,1,30,22,44,8,2,50
05M469,2002,46,35,6,0,0,0,42,3,1,0,0,23,23,46,0,2,44
05M469,2001,37,27,0,0,0,0,32,5,0,0,0,21,16,37,0,3,34
05M499,2017,187,142,142,58,16,4,125,53,2,2,1,94,93,142,45,29,158
05M499,2016,207,175,175,35,10,2,153,47,4,0,1,118,89,164,43,24,183
05M499,2015,238,177,170,29,24,2,170,57,8,0,1,117,121,174,64,24,214
05M499,2014,238,182,176,19,7,6,166,52,5,0,9,109,129,170,68,30,208
05M499,2013,273,207,199,46,7,4,197,59,5,3,5,127,146,194,79,22,251
05M499,2012,243,173,172,33,1,5,177,49,1,0,11,99,144,168,75,16,227
05M499,2011,237,151,146,48,14,4,165,60,7,0,1,107,130,172,65,33,204
05M499,2010,251,159,156,56,15,3,182,63,3,0,0,117,134,168,83,16,235
05M499,2009,261,189,189,49,12,2,195,61,3,0,0,124,137,189,72,12,249
05M499,2008,260,198,198,67,20,4,188,64,2,2,0,135,125,175,85,12,248
05M499,2007,204,182,181,71,9,4,152,45,3,0,0,97,107,133,71,5,199
05M499,2006,259,214,207,76,9,5,189,63,2,0,0,130,129,175,84,10,249
05M499,2005,212,167,154,60,7,2,151,59,0,0,0,107,105,158,54,9,203
05M499,2004,208,141,135,42,11,3,148,56,1,0,0,116,92,133,75,9,199
05M499,2003,197,166,156,56,7,2,160,35,0,0,0,115,82,180,17,3,194
05M499,2002,171,135,110,44,6,1,108,22,3,0,0,97,74,165,6,3,168
05M499,2001,134,121,115,75,3,0,144,26,1,0,0,85,49,133,1,1,133
05M670,2017,79,60,60,0,2,4,59,29,1,0,0,47,32,64,15,17,62
05M670,2016,93,79,79,0,1,2,61,18,0,0,0,51,42,55,38,25,68
05M670,2015,84,65,56,0,5,2,59,14,1,0,2,42,42,63,21,13,71
05M670,2014,81,60,55,0,2,1,70,14,0,0,0,51,30,57,24,9,72
05M670,2013,101,82,57,0,3,1,67,28,0,2,2,54,47,73,28,24,77
05M670,2012,78,58,48,0,8,2,67,25,0,1,0,41,37,47,31,16,62
05M670,2011,85,66,56,0,1,1,74,23,1,0,0,46,39,67,18,18,67
05M670,2010,99,79,69,0,4,1,77,10,0,0,0,45,54,69,30,16,83
05M670,2009,100,89,81,2,3,0,53,23,0,1,2,63,37,73,27,15,85
05M670,2008,76,64,59,1,1,0,60,21,0,0,3,48,28,57,19,7,69
05M670,2007,95,71,61,1,4,0,80,21,0,0,0,54,41,49,46,18,77
05M670,2006,95,65,56,1,10,0,71,28,0,0,0,44,51,65,30,13,82
05M670,2005,99,87,61,7,2,0,64,11,1,0,0,54,45,63,36,14,85
05M670,2004,88,65,37,0,3,0,70,24,1,0,0,50,38,53,35,6,82
05M670,2003,72,48,17,0,7,0,56,15,0,0,1,39,33,52,20,4,68
05M670,2002,54,44,17,0,2,0,48,5,0,1,0,32,22,41,13,2,52
05M670,2001,72,60,25,0,4,0,62,10,0,0,0,47,25,51,21,3,69
05M685,2012,33,13,9,0,13,1,70,62,0,0,1,9,24,27,6,15,18
05M685,2011,83,29,20,0,31,1,67,61,0,0,0,36,47,60,23,35,48
05M685,2010,93,21,18,0,27,1,42,48,0,0,0,44,49,78,15,22,71
05M685,2009,125,32,28,0,23,0,22,11,0,0,0,67,58,99,26,17,108
05M685,2008,134,40,35,0,24,0,43,39,1,0,0,77,57,76,58,29,105
05M685,2007,129,47,38,1,29,0,51,41,0,1,0,64,65,89,40,27,102
05M685,2006,121,45,26,0,22,0,72,52,1,0,0,62,59,73,48,20,101
05M685,2005,135,77,61,3,13,0,51,67,1,1,1,71,64,78,57,25,110
05M685,2004,91,43,29,0,14,0,70,65,0,0,0,46,45,64,27,18,73
05M685,2003,91,39,22,0,21,0,53,38,0,0,0,47,44,56,35,14,77
05M685,2002,73,37,27,0,12,0,40,33,0,0,0,39,34,69,4,10,63
05M685,2001,72,42,28,0,6,0,36,35,0,1,0,41,31,63,9,12,60
05M692,2017,139,139,139,136,0,50,9,26,39,1,14,50,89,59,80,5,134
05M692,2016,124,124,124,119,0,37,10,14,40,1,22,48,76,54,70,4,120
05M692,2015,106,105,105,96,0,34,12,22,27,0,11,35,71,57,49,5,101
05M692,2014,108,105,105,101,1,52,11,14,26,0,5,30,78,52,56,3,105
05M692,2013,106,104,104,96,0,44,4,25,30,1,2,30,76,54,52,6,100
05M692,2012,135,132,132,127,0,33,18,37,41,2,4,44,91,70,65,4,131
05M692,2011,95,93,93,84,2,45,11,19,19,0,1,30,65,60,35,2,93
05M692,2010,88,86,86,71,1,34,10,19,24,1,0,28,60,48,40,0,88
05M692,2009,93,89,89,82,0,28,16,19,29,0,1,37,56,48,45,2,91
05M692,2008,99,96,96,85,0,32,20,24,22,0,1,32,67,45,54,2,97
05M692,2007,111,103,103,94,1,29,27,31,24,0,0,38,73,37,74,1,110
05M692,2006,106,101,101,93,0,27,18,38,20,0,3,49,57,36,70,2,104
05M692,2005,108,107,107,102,1,32,17,31,28,0,0,37,71,13,95,3,105
05M692,2004,118,116,116,102,0,28,18,34,30,1,7,47,71,17,101,1,117
05M692,2003,80,80,80,66,0,20,15,28,14,0,3,23,57,20,60,0,80
05M692,2002,85,1,1,1,1,29,26,9,21,0,0,38,47,7,78,0,85
06M211,2017,102,89,89,8,4,2,11,74,2,0,0,51,51,95,7,26,76
06M211,2016,89,65,56,4,4,3,18,61,2,0,2,37,52,84,5,28,61
06M211,2015,98,55,48,0,1,0,12,87,1,0,2,38,60,91,7,26,72
06M211,2014,86,74,71,4,0,0,18,77,2,0,1,36,50,78,8,13,73
06M293,2017,88,87,87,23,0,3,4,76,3,0,2,49,39,71,17,13,75
06M293,2016,90,85,85,32,2,2,6,79,3,0,0,38,52,70,20,13,77
06M293,2015,74,70,69,20,1,1,3,67,2,1,0,48,26,64,10,6,68
06M293,2014,84,83,83,17,0,2,3,76,3,0,0,49,35,68,16,7,77
06M293,2013,79,75,73,12,0,2,1,82,1,0,0,42,37,57,22,17,62
06M293,2012,88,85,85,13,0,0,1,78,0,0,0,49,39,66,22,9,79
06M293,2011,86,81,81,16,0,0,6,82,0,0,0,52,34,73,13,10,76
06M293,2010,78,75,73,21,0,0,4,72,2,0,0,54,24,70,8,9,69
06M293,2009,81,70,70,13,0,0,6,74,1,0,0,52,29,74,7,9,72
06M293,2008,55,51,51,14,1,0,6,49,0,0,0,40,15,46,9,6,49
06M346,2017,104,92,92,31,4,1,6,97,0,0,0,57,47,94,10,17,87
06M346,2016,110,95,92,24,0,1,2,105,2,0,0,68,42,102,8,18,92
06M346,2015,101,77,71,6,3,1,5,91,2,2,0,49,52,91,10,12,89
06M346,2014,89,71,60,3,3,1,8,68,3,1,0,40,49,84,5,13,76
06M346,2013,81,63,52,0,3,1,4,62,0,0,0,45,36,73,8,12,69
06M346,2012,91,65,52,1,3,0,3,86,0,0,0,46,45,87,4,26,65
06M346,2011,75,40,35,1,3,0,5,83,2,0,1,21,54,63,12,19,56
06M346,2010,67,39,36,0,3,0,5,68,2,0,0,34,33,59,8,15,52
06M346,2009,76,39,35,2,4,0,3,72,1,0,0,40,36,70,6,12,64
06M346,2008,64,43,43,2,2,0,6,57,1,0,0,37,27,55,9,7,57
06M348,2017,100,93,83,28,0,1,5,92,0,1,1,44,56,78,22,15,85
06M348,2016,91,83,74,12,3,1,4,85,0,0,0,41,50,77,14,18,73
06M348,2015,90,79,71,16,6,1,4,91,0,0,1,42,48,72,18,15,75
06M348,2014,91,63,55,9,8,0,7,83,1,0,0,37,54,76,15,15,76
06M348,2013,97,70,67,8,5,0,8,83,0,0,0,39,58,61,36,19,78
06M348,2012,85,58,56,9,5,0,3,78,3,0,1,38,47,66,19,18,67
06M348,2011,77,50,47,10,3,0,4,73,0,0,0,39,38,60,17,19,58
06M348,2010,94,60,56,9,0,0,1,93,0,0,0,31,63,63,31,13,81
06M348,2009,86,47,45,13,4,0,6,77,0,0,1,39,47,86,0,12,74
06M348,2008,84,55,53,9,3,0,0,86,0,0,0,43,41,84,0,14,70
06M423,2017,56,36,32,0,5,1,14,42,0,0,0,23,33,53,3,7,49
06M423,2016,53,23,22,0,10,0,4,51,1,0,0,29,24,51,2,7,46
06M423,2015,71,39,34,0,12,0,2,50,1,0,0,37,34,68,3,15,56
06M423,2014,59,26,19,0,4,0,7,62,1,1,0,31,28,56,3,12,47
06M423,2013,57,17,13,0,10,0,5,53,1,0,0,25,32,48,9,17,40
06M423,2012,72,26,21,0,9,0,19,53,0,0,0,37,35,61,11,23,49
06M423,2011,64,15,12,0,16,0,11,51,0,2,0,35,29,58,6,17,47
06M423,2010,55,20,14,0,14,0,8,46,0,1,0,20,35,45,10,18,37
06M423,2009,74,31,28,0,13,0,22,51,0,1,0,36,38,63,11,20,54
06M462,2017,88,80,80,33,2,1,4,145,2,0,0,31,57,83,5,19,69
06M462,2016,77,66,66,23,2,1,7,151,3,0,0,40,37,71,6,12,65
06M462,2015,99,71,60,21,5,2,14,157,2,1,0,36,63,96,3,12,87
06M462,2014,103,66,52,14,8,3,9,155,2,0,0,49,54,101,2,24,79
06M462,2013,101,51,39,5,8,1,15,164,3,2,0,44,57,97,4,26,75
06M462,2012,101,54,48,2,8,1,11,138,1,1,0,40,61,94,7,18,83
06M462,2011,135,62,54,2,17,0,9,78,0,0,1,53,82,126,9,27,108
06M462,2010,152,79,77,3,19,0,7,68,1,1,0,50,102,143,9,31,121
06M462,2009,162,97,95,4,17,0,3,94,2,0,0,69,93,148,14,18,144
06M462,2008,176,96,95,0,27,0,11,91,0,0,1,73,103,162,14,25,151
06M462,2007,169,105,89,7,26,0,6,92,1,0,2,71,98,159,10,25,144
06M462,2006,185,137,101,10,17,0,6,94,1,0,0,91,94,171,14,21,164
06M462,2005,152,116,81,5,11,0,11,122,1,0,1,58,94,131,21,17,135
06M462,2004,152,107,69,12,13,0,9,143,0,0,0,63,89,129,23,29,123
06M462,2003,146,102,61,7,15,0,11,135,0,0,0,72,74,106,40,15,131
06M462,2002,49,20,13,0,6,0,8,41,0,0,0,18,31,35,14,10,39
06M462,2001,135,93,3,0,14,0,3,130,2,0,0,58,77,111,24,9,126
06M463,2017,89,70,70,19,4,1,6,82,0,0,0,41,48,84,5,17,72
06M463,2016,89,69,69,10,2,1,12,76,0,0,0,42,47,83,6,9,80
06M463,2015,89,59,41,0,10,1,11,86,2,1,0,47,42,87,2,17,72
06M463,2014,101,52,45,0,9,1,11,93,0,0,1,49,52,97,4,12,89
06M463,2013,106,49,38,0,17,1,15,118,3,0,1,46,60,94,12,20,86
06M463,2012,138,67,62,0,24,5,17,89,1,1,0,53,85,121,17,29,109
06M463,2011,113,57,51,0,22,3,4,129,1,0,0,44,69,96,17,24,89
06M463,2010,122,69,65,0,11,2,7,152,0,0,0,44,78,112,10,21,101
06M463,2009,124,66,63,4,22,1,13,134,0,0,0,50,74,108,16,15,109
06M463,2008,137,79,77,11,17,1,10,131,0,0,0,45,92,121,16,20,117
06M463,2007,149,72,60,4,20,0,2,84,3,0,0,58,91,127,22,17,132
06M463,2006,161,101,80,17,20,0,13,107,2,0,0,62,99,128,33,15,146
06M463,2005,148,84,48,8,13,0,12,110,0,2,0,64,84,113,35,16,132
06M463,2004,108,70,42,7,11,0,7,142,0,0,0,54,54,89,19,10,98
06M463,2003,134,81,47,5,20,0,4,104,0,0,0,58,76,110,24,9,125
06M463,2002,116,70,50,0,11,0,12,121,0,0,1,50,66,87,29,8,108
06M463,2001,142,95,58,1,13,0,7,107,2,0,0,70,72,113,29,9,133
06M467,2017,108,63,63,0,15,2,15,89,2,0,0,44,64,101,7,37,71
06M467,2016,127,54,48,5,10,1,19,119,2,0,0,67,60,109,18,29,98
06M467,2015,141,73,68,2,39,2,18,105,1,1,0,74,67,120,21,25,116
06M467,2014,154,98,87,4,21,2,24,153,4,1,0,67,87,134,20,34,120
06M467,2013,127,90,86,3,14,3,20,140,3,0,0,56,71,94,33,25,102
06M467,2012,141,89,82,3,16,1,15,124,0,0,0,61,80,108,33,31,110
06M467,2011,184,115,107,0,20,1,21,116,1,0,0,65,119,131,53,44,140
06M467,2010,166,112,104,4,21,1,6,162,2,0,0,76,90,119,47,32,134
06M467,2009,140,83,78,3,24,3,5,142,0,0,0,64,76,94,46,14,126
06M467,2008,139,84,76,7,32,2,23,137,0,0,0,54,85,95,44,25,114
06M467,2007,174,125,117,8,24,0,18,105,3,1,0,93,81,124,50,23,151
06M467,2006,171,122,97,16,16,0,25,127,2,0,0,96,75,110,61,21,150
06M467,2005,150,112,82,17,2,0,24,115,2,0,0,80,70,93,57,9,141
06M467,2004,110,78,52,8,10,0,7,164,3,0,0,53,57,74,36,9,101
06M467,2003,132,93,59,1,21,0,3,106,0,1,0,60,72,105,27,4,128
06M467,2002,136,88,42,4,11,0,12,119,1,0,0,76,60,118,18,4,132
06M467,2001,162,113,67,4,17,0,12,124,0,0,0,79,83,139,23,11,151
06M468,2017,112,76,76,12,7,1,13,98,0,0,0,60,52,99,13,23,89
06M468,2016,117,85,83,7,11,2,17,95,1,0,2,62,55,112,5,24,93
06M468,2015,82,57,41,1,12,2,8,71,0,0,1,37,45,79,3,12,70
06M468,2014,106,75,60,2,15,2,11,92,1,0,0,42,64,102,4,25,81
06M468,2013,106,61,56,1,20,1,15,88,1,1,0,46,60,106,0,15,91
06M468,2012,135,87,71,1,18,3,18,111,2,1,0,54,81,129,6,32,103
06M468,2011,130,85,76,1,13,1,18,149,2,0,0,69,61,123,7,33,97
06M468,2010,170,92,88,2,25,4,15,144,1,0,0,84,86,145,25,19,151
06M468,2009,164,68,66,10,28,1,7,160,1,0,0,66,98,152,12,25,139
06M468,2008,169,86,81,7,38,1,7,153,0,1,0,85,84,156,13,16,153
06M468,2007,175,81,65,14,24,2,7,116,1,0,0,94,81,161,14,26,149
06M468,2006,158,88,51,14,33,3,5,98,0,0,0,75,83,136,22,23,135
06M468,2005,162,108,67,19,16,1,20,131,3,0,0,82,80,143,19,21,141
06M468,2004,126,83,43,7,14,0,27,100,2,0,1,58,68,112,14,18,108
06M468,2003,170,95,42,4,41,0,13,157,4,1,0,77,93,121,49,14,156
06M468,2002,106,60,32,2,16,0,14,142,2,0,0,58,48,84,22,6,100
06M468,2001,155,83,47,4,22,0,9,161,0,0,0,89,66,116,39,10,145
06M540,2017,338,266,264,138,16,10,95,221,8,1,3,179,159,283,55,48,290
06M540,2016,273,197,194,106,20,15,74,175,8,1,0,141,132,243,30,36,237
06M540,2015,309,244,229,37,18,18,85,193,9,2,2,161,148,261,48,31,278
06M540,2014,239,178,170,29,25,12,70,141,7,2,7,112,127,209,30,41,198
06M540,2013,331,233,227,40,24,20,108,194,6,0,3,156,175,272,59,43,288
06M540,2012,323,229,220,29,21,16,100,196,5,0,6,171,152,246,77,39,284
06M540,2011,224,168,168,22,5,13,78,129,3,1,0,120,104,174,50,17,207
06M540,2010,271,190,189,32,13,10,80,177,1,1,2,139,132,209,62,8,263
06M540,2009,344,234,234,30,18,15,131,195,2,1,0,170,174,265,79,21,323
06M540,2008,305,214,213,58,21,9,89,204,3,0,0,142,163,220,85,18,287
06M540,2007,327,265,261,76,17,5,110,212,0,0,0,184,143,239,88,23,304
06M540,2006,267,190,173,43,8,15,86,161,3,2,0,131,136,169,98,21,246
06M540,2005,228,197,197,70,3,15,71,137,2,2,1,160,68,171,57,3,225
06M540,2004,445,261,211,54,55,8,142,293,2,0,0,218,227,306,139,41,404
06M540,2003,385,243,187,49,43,6,112,266,1,0,0,216,169,263,122,23,362
06M540,2002,290,177,140,31,37,8,123,158,0,1,0,174,116,199,91,13,277
06M540,2001,307,204,156,72,42,11,151,135,9,1,0,176,131,175,132,21,286
06M552,2017,156,150,150,43,3,0,0,156,0,0,0,91,65,146,10,4,152
06M552,2016,129,117,117,28,5,0,0,129,0,0,0,77,52,117,12,2,127
06M552,2015,148,114,107,10,11,0,0,148,0,0,0,70,78,144,4,2,146
06M552,2014,116,88,86,5,11,0,0,116,0,0,0,66,50,111,5,1,115
06M552,2013,132,79,76,13,10,0,0,132,0,0,0,73,59,120,12,4,128
06M552,2012,124,79,79,1,11,0,0,124,0,0,0,68,56,123,1,0,124
06M552,2011,93,64,62,9,10,0,0,93,0,0,0,53,40,88,5,1,92
06M552,2010,101,56,55,15,16,0,0,101,0,0,0,53,48,94,7,1,100
06M552,2009,159,96,90,25,21,0,0,159,0,0,0,74,85,146,13,1,158
06M552,2008,89,62,60,7,12,0,0,89,0,0,0,47,42,86,3,0,89
06M552,2007,89,54,53,20,6,0,0,89,0,0,0,51,38,86,3,0,89
06M552,2006,91,74,49,13,8,0,0,91,0,0,0,51,40,85,6,0,91
06M552,2005,89,65,35,10,9,0,0,89,0,0,0,44,45,85,4,0,89
06M552,2004,81,64,33,4,8,0,0,81,0,0,0,40,41,73,8,0,81
06M552,2003,109,79,33,2,7,0,0,109,0,0,0,69,40,103,6,0,109
06M552,2002,76,38,14,1,12,0,0,76,0,0,0,41,35,64,12,0,76
06M552,2001,78,44,13,0,11,0,0,78,0,0,0,37,41,65,13,3,75
07X221,2017,81,74,72,20,0,2,20,53,5,1,0,43,38,78,3,20,61
07X221,2016,102,96,92,24,0,2,24,76,0,0,0,58,44,98,4,23,79
07X221,2015,89,79,72,9,1,3,28,57,0,0,1,39,50,79,10,21,68
07X221,2014,92,85,73,10,1,2,23,65,2,0,0,55,37,87,5,20,72
07X221,2013,78,72,70,19,0,3,20,50,2,2,1,34,44,67,11,13,65
07X221,2012,79,73,68,11,0,2,27,53,2,0,0,35,44,78,1,18,61
07X221,2011,78,72,66,8,2,1,20,57,0,0,0,44,34,76,2,16,62
07X221,2010,84,71,67,7,3,1,21,50,0,0,0,43,41,80,4,18,66
07X221,2009,78,60,56,5,2,1,22,43,0,0,0,41,37,67,11,15,63
07X221,2008,72,60,56,3,3,0,18,59,1,1,0,41,31,52,20,14,58
07X221,2007,66,55,47,4,2,0,23,55,0,0,0,36,30,66,0,5,61
07X221,2006,80,64,51,6,3,0,27,53,0,0,0,54,26,79,1,10,70
07X221,2005,61,52,32,7,2,0,28,32,0,1,0,31,30,59,2,9,52
07X221,2004,71,52,24,2,7,0,17,53,0,1,0,43,28,58,13,20,51
07X223,2017,88,84,84,0,0,1,19,68,0,0,0,45,43,83,5,19,69
07X223,2016,90,85,85,0,2,1,13,76,0,0,0,47,43,87,3,15,75
07X223,2015,85,72,71,0,3,1,16,68,0,0,0,33,52,81,4,15,70
07X223,2014,117,100,98,0,3,0,26,88,2,0,1,65,52,115,2,19,98
07X223,2013,90,73,72,0,1,0,20,70,0,0,0,39,51,86,4,20,70
07X259,2017,91,84,84,0,4,4,34,52,0,0,1,65,26,75,16,21,70
07X259,2016,97,76,76,0,4,1,48,47,0,1,0,71,26,80,17,21,76
07X259,2015,109,79,69,0,9,1,36,60,1,2,0,80,29,85,24,23,86
07X259,2014,100,71,63,0,12,2,45,60,0,0,2,65,35,85,15,21,79
07X259,2013,109,67,64,0,10,0,38,67,0,1,3,73,36,76,33,15,94
07X334,2017,103,69,69,0,8,4,19,72,7,0,1,46,57,98,5,13,90
07X334,2016,142,81,79,0,29,6,16,115,3,1,1,64,78,138,4,13,129
07X334,2015,121,94,91,0,19,4,19,95,2,1,0,60,61,119,2,5,116
07X334,2014,85,69,69,0,14,3,10,72,0,0,0,36,49,80,5,3,82
07X334,2013,108,66,64,0,25,4,13,88,1,2,0,43,65,100,8,9,99
07X334,2012,88,57,56,0,16,11,15,59,0,3,0,37,51,84,4,0,88
07X334,2011,91,48,47,2,4,4,14,69,1,3,0,51,40,90,1,4,87
07X334,2010,94,32,31,0,20,9,14,69,1,1,0,49,45,84,10,3,91
07X334,2009,113,28,28,2,31,2,26,58,4,0,0,58,55,95,18,3,110
07X334,2008,90,42,33,0,19,0,28,83,1,1,0,43,47,76,14,5,85
07X334,2006,10,1,0,0,5,0,0,9,1,0,0,4,6,5,5,1,9
07X379,2017,78,17,14,0,4,3,22,63,0,0,1,36,42,69,9,31,47
07X379,2016,89,20,15,0,5,1,20,50,1,0,3,50,39,78,11,27,62
07X379,2015,75,2,1,0,22,3,28,66,1,1,0,42,33,66,9,26,49
07X379,2014,99,5,5,0,16,1,33,62,1,1,0,52,47,80,19,20,79
07X379,2013,98,12,9,0,16,1,32,47,2,0,0,55,43,80,18,32,66
07X379,2012,101,13,10,0,20,1,22,51,0,2,0,65,36,80,21,24,77
07X379,2011,82,16,13,0,13,1,36,50,2,0,0,43,39,61,21,20,62
07X379,2010,104,23,17,0,15,1,38,53,0,0,0,69,35,83,21,23,81
07X379,2009,76,8,8,1,24,1,40,33,0,0,1,45,31,76,0,7,69
07X379,2008,89,6,6,0,33,0,33,44,1,0,0,60,29,89,0,9,80
07X379,2007,92,10,7,0,10,0,37,62,0,1,1,50,42,91,1,10,82
07X379,2006,50,5,0,0,8,0,25,75,3,0,1,30,20,42,8,5,45
07X379,2005,75,12,1,0,12,0,25,25,0,0,0,44,31,63,12,5,70
07X379,2004,44,5,0,0,3,0,19,24,1,0,0,17,27,40,4,5,39
07X379,2003,10,0,0,0,0,0,6,4,0,0,0,5,5,7,3,0,10
07X381,2017,51,8,8,0,8,1,15,34,1,0,0,26,25,47,4,18,33
07X381,2016,74,7,7,0,7,3,14,56,1,0,0,38,36,65,9,22,52
07X381,2015,52,13,11,0,7,1,22,56,0,0,0,34,18,47,5,17,35
07X381,2014,66,4,4,0,19,1,25,57,0,0,0,33,33,61,5,12,54
07X381,2013,79,3,2,0,9,1,28,49,0,0,0,35,44,71,8,23,56
07X381,2012,83,10,9,0,15,2,22,51,1,0,0,43,40,72,11,21,62
07X381,2011,78,9,6,0,18,1,24,37,0,0,0,44,34,57,21,12,66
07X381,2010,64,9,7,0,5,1,22,47,1,0,0,34,30,56,8,19,45
07X381,2009,76,5,5,0,13,0,10,39,1,2,0,42,34,62,14,11,65
07X381,2008,62,3,2,0,19,0,30,36,0,0,0,43,19,50,12,8,54
07X381,2007,71,3,0,0,4,0,15,49,0,0,0,46,25,61,10,7,64
07X381,2006,11,8,2,0,3,0,3,8,0,0,0,8,3,10,1,0,11
07X381,2005,53,5,0,0,4,0,21,31,1,0,0,35,18,44,9,4,49
07X427,2017,79,45,45,0,13,1,18,52,1,0,0,41,38,74,5,22,57
07X427,2016,62,37,37,0,18,1,21,46,1,0,0,32,30,57,5,16,46
07X427,2015,72,50,45,0,17,1,22,49,1,0,0,43,29,68,4,23,49
07X427,2014,65,42,41,0,17,1,26,61,0,0,0,35,30,59,6,16,49
07X427,2013,72,42,42,0,12,1,26,45,0,0,0,40,32,66,6,21,51
07X427,2012,69,48,46,0,10,1,35,49,1,0,0,39,30,65,4,17,52
07X427,2011,73,40,38,0,16,0,19,59,1,0,0,33,40,63,10,13,60
07X427,2010,88,52,48,0,18,0,17,44,0,1,0,46,42,73,15,19,69
07X427,2009,72,47,46,0,14,0,13,57,1,0,1,33,39,64,8,15,57
07X427,2008,79,46,43,0,15,0,25,39,1,0,0,44,35,65,14,19,60
07X427,2007,76,52,50,0,6,0,32,46,1,0,0,51,25,65,11,13,63
07X427,2006,81,52,42,0,16,0,26,47,3,0,0,47,34,75,6,17,64
07X427,2005,82,41,7,0,16,0,34,46,0,1,0,50,32,76,6,19,63
07X427,2004,86,62,22,0,11,0,22,56,1,3,0,43,43,74,12,7,79
07X427,2003,75,43,10,0,8,0,29,46,0,0,0,37,38,67,8,6,69
07X427,2002,64,35,0,0,1,0,28,31,4,1,0,40,24,47,17,4,60
07X470,2002,8,0,0,0,3,0,1,7,0,0,0,22,31,20,33,2,0
07X470,2001,53,9,0,0,27,0,6,46,0,1,0,0,2,0,2,8,0
07X473,2017,70,34,34,0,11,1,15,62,1,0,1,23,47,63,7,18,52
07X473,2016,67,41,41,0,11,1,14,73,0,0,0,25,42,65,2,22,45
07X473,2015,80,37,33,0,20,2,24,69,0,1,0,45,35,80,0,24,56
07X473,2014,96,43,36,0,23,1,22,55,0,1,1,46,50,89,7,27,69
07X473,2013,97,49,45,1,16,3,14,52,0,0,0,40,57,91,6,22,75
07X473,2012,85,49,43,0,9,0,24,45,1,0,0,39,46,78,7,23,62
07X473,2011,88,40,38,0,9,0,17,48,0,2,0,48,40,84,4,16,72
07X473,2010,93,45,41,0,10,0,24,70,1,0,1,40,53,86,7,17,76
07X473,2009,96,38,35,0,14,0,27,68,1,0,1,50,46,92,4,21,75
07X473,2008,80,49,43,0,9,0,25,60,0,0,0,41,39,65,15,20,60
07X473,2007,85,43,31,0,14,0,26,67,0,0,0,39,46,65,20,19,66
07X473,2006,69,44,23,0,10,0,22,63,0,0,0,32,37,55,14,16,53
07X473,2005,97,55,29,2,6,0,27,70,0,0,0,50,47,74,23,15,82
07X473,2004,69,53,21,0,4,0,28,41,0,0,0,36,33,58,11,9,60
07X473,2003,65,48,14,2,4,0,25,40,0,0,0,40,25,53,12,7,58
07X473,2002,72,54,14,0,2,0,30,42,0,0,0,38,34,67,5,5,67
07X495,2017,154,152,152,0,1,13,37,94,2,2,6,87,67,123,31,27,127
07X495,2016,132,132,132,0,0,5,33,86,4,1,3,85,47,111,21,23,109
07X495,2015,106,104,104,0,1,2,33,66,2,1,2,63,43,97,9,17,89
07X495,2014,103,103,103,0,0,6,26,69,0,2,0,55,48,89,14,16,87
07X495,2013,121,119,119,0,2,3,31,84,3,0,0,71,50,111,10,11,110
07X495,2012,120,114,114,0,0,4,39,74,3,0,0,71,49,106,14,10,110
07X495,2011,115,103,103,0,1,4,37,73,1,0,0,62,53,96,19,9,106
07X495,2010,97,88,88,0,2,2,16,79,0,0,0,49,48,83,14,1,96
07X495,2009,130,108,108,0,10,1,13,112,4,0,0,82,48,122,8,13,117
07X495,2008,108,93,93,0,7,2,22,83,1,0,0,61,47,98,10,8,100
07X495,2007,110,95,45,0,7,2,20,86,2,0,0,69,41,101,9,9,101
07X495,2006,117,106,47,0,9,1,27,88,1,0,0,67,50,108,9,14,103
07X495,2005,106,92,51,0,9,1,26,65,0,0,0,63,43,88,18,10,96
07X495,2004,88,74,41,0,5,4,34,46,2,1,0,47,41,71,17,15,73
07X495,2003,92,78,28,0,8,0,28,78,0,0,0,49,43,73,19,10,82
07X495,2002,68,46,7,0,14,0,30,56,2,0,0,33,35,53,15,6,62
07X495,2001,87,54,10,0,11,0,22,43,3,0,0,56,31,74,13,9,78
07X500,2017,98,75,75,7,4,1,19,75,2,1,0,51,47,79,19,19,79
07X500,2016,86,78,78,7,4,4,24,55,2,1,0,53,33,70,16,14,72
07X500,2015,93,77,74,14,3,3,13,74,2,1,0,54,39,68,25,13,80
07X500,2014,79,63,60,14,3,7,18,58,1,2,0,47,32,60,19,13,66
07X500,2013,86,66,63,18,5,3,13,62,1,0,4,44,42,59,27,14,72
07X500,2012,83,67,63,21,5,4,27,44,1,0,0,46,37,58,25,15,68
07X500,2011,76,60,58,13,3,6,18,60,0,0,0,45,31,55,21,11,65
07X500,2010,84,67,62,13,3,1,31,45,0,0,0,50,34,64,20,10,74
07X500,2009,77,49,48,9,2,3,16,61,3,0,0,50,27,61,16,5,72
07X500,2008,83,59,57,23,4,1,18,68,0,0,0,47,36,53,30,12,71
07X500,2007,87,67,57,28,1,1,18,41,1,0,0,51,36,67,20,5,82
07X500,2006,61,51,49,25,1,2,26,54,0,0,0,38,23,49,12,0,61
07X500,2005,82,64,52,22,2,7,22,77,1,0,0,41,41,57,25,7,75
07X500,2004,107,91,73,48,3,7,23,64,0,0,1,67,40,68,39,4,103
07X500,2003,95,76,58,33,3,2,7,77,2,0,0,67,28,71,24,2,93
07X500,2002,88,71,54,23,1,6,22,74,1,0,0,56,32,60,28,1,87
07X500,2001,103,81,59,15,0,0,19,57,1,0,2,65,38,65,38,1,102
07X520,2012,34,19,16,0,12,1,16,31,1,0,0,18,16,28,6,9,25
07X520,2011,44,17,15,0,9,4,19,67,1,0,0,19,25,40,4,16,28
07X520,2010,49,20,20,0,9,3,27,71,1,3,0,25,24,44,5,13,36
07X520,2009,91,37,36,0,11,3,25,80,0,1,0,53,38,82,9,17,74
07X520,2008,105,47,45,3,17,1,31,102,1,1,0,61,44,94,11,20,85
07X520,2007,109,59,44,4,16,3,22,77,2,0,0,58,51,95,14,20,89
07X520,2006,136,82,59,14,10,2,22,71,1,0,0,72,64,117,19,25,111
07X520,2005,104,63,51,1,10,2,16,59,1,0,1,64,40,93,11,11,93
07X520,2004,96,62,41,3,10,1,20,40,4,1,0,56,40,85,11,13,83
07X520,2003,79,49,32,3,6,0,1,4,0,0,0,43,36,57,22,13,66
07X520,2002,66,52,38,9,6,0,1,3,0,0,0,36,30,48,18,5,61
07X520,2001,71,56,38,1,2,0,25,44,2,0,0,50,21,49,22,3,68
07X522,2017,84,61,61,19,20,2,33,84,0,2,0,9,75,76,8,21,63
07X522,2016,121,80,77,14,23,2,33,82,3,0,0,21,100,104,17,37,84
07X522,2015,98,64,53,2,19,1,25,99,9,0,0,20,78,86,12,30,68
07X522,2014,120,56,48,3,23,4,32,93,0,1,0,29,91,97,23,29,91
07X522,2013,134,68,57,1,15,0,25,56,2,1,0,21,113,125,9,35,99
07X522,2012,130,75,65,0,26,0,23,71,1,2,1,19,111,122,8,30,100
07X522,2011,118,47,35,0,25,0,33,83,0,2,0,19,99,98,20,29,89
07X527,2017,144,110,108,39,11,1,45,98,0,0,0,68,76,130,14,51,93
07X527,2016,142,99,99,36,11,3,36,91,2,1,0,59,83,129,13,44,98
07X527,2015,133,100,79,8,17,2,43,86,3,0,1,61,72,125,8,41,92
07X527,2014,135,84,67,6,23,3,37,81,0,0,3,60,75,127,8,40,95
07X527,2013,124,88,74,5,10,1,39,86,0,0,2,44,80,111,13,32,92
07X527,2012,128,98,87,9,9,5,43,72,1,0,0,59,69,108,20,39,89
07X527,2011,121,70,66,10,19,3,65,81,3,1,0,47,74,106,15,34,87
07X527,2010,153,95,92,8,25,2,45,61,0,1,0,65,88,134,19,26,127
07X527,2009,97,57,52,2,20,3,40,58,0,1,0,50,47,87,10,18,79
07X527,2008,106,64,60,5,18,1,51,43,2,1,1,53,53,85,21,19,87
07X527,2007,109,62,47,2,20,4,31,16,1,0,0,49,60,89,20,28,81
07X527,2006,102,74,56,7,15,0,36,104,0,1,1,52,50,101,1,17,85
07X527,2005,71,53,29,3,5,0,39,58,0,0,0,33,38,71,0,15,56
07X527,2004,99,70,49,9,7,0,44,62,0,0,0,62,37,98,1,9,90
07X527,2003,57,44,26,3,2,0,31,38,1,0,1,37,20,57,0,4,53
07X527,2002,52,0,0,0,0,0,36,17,0,0,4,36,16,52,0,1,51
07X547,2015,7,0,0,0,6,1,23,66,1,0,0,36,29,7,0,17,48
07X547,2014,65,34,27,1,20,1,27,58,0,0,0,60,27,52,13,25,62
07X547,2013,87,40,36,0,24,1,29,51,0,0,0,53,38,61,26,24,67
07X547,2012,91,42,35,1,25,0,2,0,0,0,0,49,74,68,23,35,88
07X547,2011,123,67,62,1,12,0,1,6,0,0,0,23,50,106,17,20,53
07X547,2010,73,37,32,0,6,0,23,64,0,0,0,46,40,67,6,21,65
07X547,2009,86,39,31,1,22,0,39,81,1,2,0,39,46,75,11,22,63
07X547,2008,85,39,32,0,14,0,17,56,0,0,0,31,51,73,12,17,65
07X547,2007,82,41,24,1,17,0,28,55,2,0,0,29,52,78,4,13,68
07X547,2006,81,36,18,0,14,0,29,53,0,0,0,29,43,70,11,10,62
07X547,2005,72,51,26,1,9,0,28,43,1,0,0,34,45,65,7,14,65
07X547,2004,79,43,10,0,8,0,31,46,1,1,0,32,41,73,6,15,58
07X547,2003,73,44,6,0,6,0,27,45,1,0,0,36,41,67,6,10,67
07X547,2002,77,53,14,0,6,0,27,50,0,0,0,1,1,74,3,0,2
07X548,2017,114,87,86,2,17,1,30,83,0,0,0,33,81,95,19,27,87
07X548,2016,125,95,95,0,20,1,39,83,2,0,0,28,97,107,18,32,93
07X548,2015,133,78,69,0,29,1,42,88,4,0,0,29,104,107,26,29,104
07X548,2014,135,74,70,1,16,1,37,95,1,0,0,25,110,124,11,35,100
07X548,2013,134,91,81,0,13,1,30,109,2,4,3,28,106,117,17,26,108
07X548,2012,155,106,89,4,16,1,25,72,0,2,0,21,134,137,18,41,114
07X548,2011,137,102,96,7,4,1,22,57,0,1,1,32,105,120,17,33,104
07X548,2010,149,102,86,5,13,2,19,61,0,0,0,22,127,119,30,29,120
07X548,2009,100,57,47,4,6,1,3,66,0,0,0,18,82,78,22,23,77
07X548,2008,84,57,52,1,9,0,30,96,5,2,0,11,73,63,21,18,66
07X548,2007,82,65,55,2,5,0,49,104,2,0,0,15,67,59,23,8,74
07X548,2006,82,65,50,3,5,0,46,87,4,0,0,15,67,63,19,11,71
07X548,2005,72,59,47,8,1,0,26,57,0,0,1,10,62,58,14,8,64
07X548,2004,70,65,33,4,1,0,22,47,1,1,1,14,56,54,16,8,62
07X548,2003,76,62,34,7,1,0,23,47,0,0,0,29,47,58,18,2,74
07X548,2002,81,57,34,4,1,0,30,45,1,0,0,40,41,77,4,17,64
07X548,2001,70,61,17,0,0,0,23,58,0,0,0,39,31,70,0,7,63
07X551,2017,79,61,60,0,1,1,24,51,3,0,0,36,43,72,7,26,53
07X551,2016,86,70,62,0,6,2,20,63,1,0,0,46,40,74,12,18,68
07X551,2015,80,66,49,0,1,1,22,52,4,0,1,38,42,71,9,24,56
07X551,2014,84,67,54,2,7,2,20,50,0,0,1,41,43,68,16,20,64
07X551,2013,73,58,48,0,7,1,33,42,0,0,0,43,30,58,15,17,56
07X551,2012,75,40,37,0,13,2,26,35,0,0,0,47,28,62,13,20,55
07X551,2011,82,48,44,0,6,3,29,56,0,1,0,42,40,76,6,13,69
07X551,2010,80,52,48,0,8,1,23,51,1,0,0,50,30,66,14,12,68
07X551,2009,76,61,58,1,2,1,30,36,2,0,0,40,36,69,7,12,64
07X551,2008,63,46,43,1,4,1,25,39,0,1,0,40,23,52,11,11,52
07X551,2007,89,73,68,11,3,3,26,35,0,0,0,62,27,75,14,12,77
07X551,2006,76,56,48,4,5,0,26,56,2,0,0,48,28,60,16,14,62
07X551,2005,69,61,55,17,1,0,18,55,2,0,0,41,28,60,9,5,64
07X551,2004,66,53,48,3,2,0,28,53,1,0,0,49,17,57,9,4,62
07X551,2003,64,57,42,6,2,0,23,55,2,0,0,44,20,52,12,5,59
07X557,2017,111,52,41,0,1,1,35,73,1,1,0,51,60,97,14,35,76
07X557,2016,110,37,29,0,3,1,20,63,4,0,0,58,52,89,21,32,78
07X557,2015,124,24,15,0,27,2,41,71,0,0,0,57,67,114,10,41,83
07X557,2014,105,19,13,0,16,0,35,67,7,1,0,43,62,91,14,33,72
07X557,2013,102,14,11,0,16,0,38,85,1,0,0,46,56,67,35,27,75
07X557,2012,88,12,8,0,13,0,28,72,5,0,0,47,41,69,19,24,64
07X557,2011,80,12,12,0,17,0,24,75,2,1,0,38,42,44,36,22,58
07X557,2010,114,6,4,0,14,0,23,55,2,0,0,57,57,95,19,38,76
07X557,2009,63,2,1,0,3,0,27,36,0,0,0,27,36,63,0,16,47
07X600,2017,101,89,89,8,1,1,23,76,1,0,0,8,93,82,19,20,81
07X600,2016,92,90,90,10,1,1,18,79,2,1,1,14,78,83,9,23,69
07X600,2015,102,86,65,1,6,2,19,69,0,0,0,14,88,93,9,30,72
07X600,2014,90,65,51,1,17,3,75,116,2,0,0,6,84,76,14,27,63
07X600,2013,79,60,53,0,10,4,84,161,2,2,0,3,76,64,15,23,56
07X600,2012,72,49,46,1,12,7,101,155,0,1,0,6,66,65,7,18,54
07X600,2011,54,34,27,3,10,4,80,182,0,1,0,9,45,49,5,15,39
07X600,2010,97,46,26,0,19,8,85,176,1,1,0,6,91,84,13,32,65
07X600,2009,196,86,75,5,39,6,88,153,2,0,0,6,190,170,26,34,162
07X600,2008,253,136,131,4,45,3,61,146,3,1,1,23,230,207,46,40,213
07X600,2007,264,114,67,12,29,4,81,149,4,1,0,31,233,217,47,62,202
07X600,2006,267,109,54,4,48,3,93,152,5,0,0,31,236,211,56,66,201
07X600,2005,271,114,71,50,70,0,22,68,2,0,0,29,242,192,79,50,221
07X600,2004,249,83,57,37,88,0,22,55,2,0,0,37,212,199,50,53,196
07X600,2003,215,90,45,35,50,0,19,51,1,0,1,32,183,157,58,52,163
07X600,2002,239,111,47,7,70,0,17,37,0,0,0,16,223,199,40,38,201
07X600,2001,253,101,44,2,72,0,36,61,0,0,0,21,232,208,45,64,189
07X655,2011,62,29,27,3,23,1,60,120,1,2,0,12,50,50,12,18,44
07X655,2010,130,40,38,0,24,5,60,146,1,2,0,28,102,95,35,38,92
07X655,2009,184,50,44,4,34,4,85,200,1,4,0,39,145,184,0,51,133
07X655,2008,214,59,58,9,45,4,101,245,4,3,0,43,171,213,1,65,149
07X655,2007,294,105,78,7,75,5,96,244,2,2,0,69,225,271,23,65,229
07X655,2006,357,173,102,12,77,5,81,219,3,5,0,94,263,334,23,74,283
07X655,2005,349,144,98,3,58,3,113,199,1,1,0,61,288,275,74,82,267
07X655,2004,313,153,112,10,53,3,88,169,0,1,0,91,222,233,80,64,249
07X655,2003,317,155,89,12,69,7,123,153,5,2,0,102,215,259,58,62,255
07X655,2002,261,131,101,3,57,0,20,40,2,0,0,50,211,231,30,37,224
07X655,2001,290,152,86,1,55,0,31,98,0,1,0,46,244,263,27,81,209
07X670,2017,110,80,80,21,17,3,60,92,3,5,0,61,49,100,10,36,74
07X670,2016,130,89,89,0,15,5,65,72,1,0,1,87,43,117,13,31,99
07X670,2015,163,94,82,1,46,3,43,91,3,2,0,97,66,137,26,35,128
07X670,2014,144,81,72,4,35,2,58,81,2,1,1,87,57,120,24,28,116
07X670,2013,142,70,62,9,42,5,54,71,2,1,0,87,55,127,15,32,110
07X670,2012,145,90,86,2,36,5,49,73,0,0,0,97,48,123,22,30,115
07X670,2011,133,77,68,6,25,5,55,80,0,0,0,84,49,114,19,28,105
07X670,2010,127,67,65,3,20,3,58,84,0,0,0,85,42,106,21,28,99
07X670,2009,140,88,84,6,21,3,52,99,0,0,0,98,42,127,13,23,117
07X670,2008,145,103,101,5,23,1,41,92,0,0,0,107,38,134,11,25,120
07X670,2007,154,109,100,14,27,5,54,66,1,0,0,106,48,119,35,18,136
07X670,2006,134,93,76,10,25,1,41,78,2,0,0,94,40,112,22,12,122
07X670,2005,126,84,59,10,11,0,37,67,2,3,1,94,32,104,22,16,110
07X670,2004,137,78,48,8,20,0,59,66,3,1,1,106,31,113,24,12,125
07X670,2003,130,69,50,5,28,0,55,82,0,0,0,91,39,86,44,13,117
07X670,2002,122,84,50,6,7,0,56,73,1,0,0,86,36,93,29,8,114
07X670,2001,108,73,45,8,3,0,51,55,1,1,0,80,28,78,30,8,100
08X269,2017,82,56,56,3,9,2,18,68,1,0,0,44,38,63,19,16,66
08X269,2016,75,56,52,3,10,1,12,61,0,0,0,40,35,66,9,16,59
08X269,2015,89,60,52,1,11,1,13,58,1,2,0,52,37,75,14,21,68
08X269,2014,74,55,53,0,7,1,13,59,0,0,0,41,33,65,9,12,62
08X269,2013,75,45,44,0,10,1,15,49,1,0,0,44,31,56,19,15,60
08X269,2012,73,43,37,0,7,2,20,51,1,0,0,36,37,55,18,22,51
08X269,2011,66,39,37,0,7,0,17,65,0,0,0,38,28,50,16,16,50
08X269,2010,64,37,35,0,12,0,17,55,2,0,1,38,26,49,15,6,58
08X269,2009,74,50,48,0,11,0,14,50,0,0,0,43,31,74,0,9,65
08X282,2017,58,41,41,13,8,2,23,21,12,0,0,58,0,52,6,10,48
08X282,2016,59,40,40,13,9,6,20,23,10,0,0,59,0,56,3,9,50
08X282,2015,64,38,36,1,13,12,25,18,6,2,1,64,0,54,10,10,54
08X282,2014,60,32,29,1,12,9,24,24,1,2,0,60,0,58,2,13,47
08X282,2013,67,45,37,3,5,3,34,26,4,0,0,67,0,60,7,15,52
08X282,2012,91,52,44,1,13,5,39,42,0,1,4,91,0,78,13,23,68
08X282,2011,93,53,51,5,12,3,44,41,2,2,1,93,0,78,15,21,72
08X282,2010,73,44,40,7,9,3,27,40,3,0,0,73,0,63,10,12,61
08X282,2009,88,53,53,4,6,3,39,43,3,0,0,88,0,76,12,10,78
08X282,2008,67,36,34,5,4,2,38,24,2,1,0,66,1,53,14,8,59
08X282,2007,65,57,49,1,6,2,49,23,1,0,0,65,0,48,17,5,60
08X282,2006,75,50,49,8,12,0,34,30,1,0,0,75,0,57,18,4,71
08X293,2017,115,98,98,23,14,8,31,67,9,0,0,66,49,85,30,25,90
08X293,2016,118,95,85,12,16,4,25,80,9,0,0,68,50,91,27,31,87
08X293,2015,119,100,88,3,11,4,28,77,8,2,0,74,45,87,32,34,85
08X293,2014,113,83,78,9,14,4,29,68,10,1,1,59,54,78,35,25,88
08X293,2013,90,60,57,3,14,5,28,53,3,0,1,51,39,56,34,19,71
08X293,2012,108,78,72,2,10,5,32,54,15,1,1,58,50,68,40,24,84
08X293,2011,129,93,89,2,11,1,30,88,10,0,0,83,46,80,49,36,93
08X293,2010,108,78,75,11,15,2,27,66,11,2,0,77,31,72,36,17,91
08X293,2009,104,82,79,3,9,1,25,69,9,0,0,60,44,104,0,20,84
08X293,2008,122,74,69,6,18,6,36,73,7,0,0,81,41,122,0,21,101
08X293,2007,126,85,75,6,25,3,42,75,5,1,0,75,51,122,4,18,108
08X293,2006,117,77,58,4,16,1,39,72,4,0,1,67,50,82,35,26,91
08X293,2005,95,66,49,3,9,3,37,49,4,1,1,66,29,66,29,5,90
08X293,2004,95,67,57,4,10,1,38,51,5,0,0,69,26,70,25,8,87
08X293,2003,41,29,17,2,3,2,11,25,3,0,0,23,18,27,14,3,38
08X295,2011,39,19,14,0,18,1,14,23,1,0,0,12,27,26,13,13,26
08X295,2010,96,37,29,2,23,7,34,52,3,0,0,40,56,70,26,28,68
08X295,2009,117,41,35,2,27,7,28,78,1,3,0,49,68,117,0,27,90
08X295,2008,152,47,46,3,35,9,61,79,2,1,0,52,100,149,3,32,120
08X295,2007,123,60,45,2,18,8,44,69,1,0,1,47,76,113,10,29,94
08X295,2006,121,49,23,5,16,5,33,82,1,0,0,50,71,95,26,25,96
08X295,2005,88,36,33,0,11,4,28,56,0,0,0,29,59,73,15,10,78
08X295,2004,87,59,31,2,11,6,39,38,3,1,0,32,55,61,26,10,77
08X295,2003,58,37,23,9,0,4,22,30,1,0,1,27,31,38,20,3,55
08X305,2014,20,5,1,0,12,4,17,51,1,1,0,10,10,17,3,6,14
08X305,2013,74,36,23,1,11,4,22,63,3,1,0,29,45,47,27,23,51
08X305,2012,93,49,27,2,13,4,17,59,2,1,0,28,65,64,29,33,60
08X305,2011,83,44,26,2,18,5,26,52,1,0,0,34,49,55,28,24,59
08X305,2010,84,52,44,0,11,5,23,61,1,0,0,28,56,59,25,21,63
08X305,2009,90,48,39,2,17,2,31,75,2,0,0,24,66,90,0,18,72
08X305,2008,110,60,52,0,24,2,32,71,2,1,0,42,68,109,1,32,78
08X305,2007,108,50,40,1,26,1,29,70,1,0,0,44,64,100,8,26,82
08X305,2006,101,57,33,0,18,1,26,91,0,0,0,35,66,76,25,21,80
08X305,2005,118,59,24,0,29,1,17,57,0,0,1,39,79,96,22,28,90
08X305,2004,76,44,14,0,12,3,20,30,0,0,0,24,52,59,17,13,63
08X305,2003,53,24,9,0,14,0,7,11,1,1,0,9,44,34,19,7,46
08X312,2017,100,78,78,0,14,1,42,55,2,0,0,66,34,85,15,26,74
08X312,2016,104,87,87,0,4,3,24,68,6,2,1,56,48,77,27,29,75
08X312,2015,103,76,59,1,11,1,24,77,0,1,0,56,47,73,30,28,75
08X312,2014,105,78,62,0,9,2,32,67,2,1,1,56,49,73,32,31,74
08X312,2013,110,77,65,2,13,2,26,82,0,0,0,62,48,80,30,31,79
08X312,2012,119,79,64,5,18,4,36,76,3,0,0,61,58,81,38,33,86
08X312,2011,129,78,71,9,18,1,50,76,1,1,0,66,63,83,46,34,95
08X312,2010,109,71,67,2,13,2,29,78,0,0,0,58,51,70,39,24,85
08X312,2009,112,68,67,0,13,2,41,66,1,2,0,54,58,112,0,22,90
08X312,2008,136,77,69,1,23,3,43,87,3,0,0,68,68,136,0,21,115
08X312,2007,115,72,57,3,13,3,41,70,1,0,0,49,66,114,1,18,97
08X312,2006,108,63,44,4,10,3,48,48,3,0,0,54,54,89,19,23,85
08X312,2005,102,61,41,2,7,7,37,46,3,1,0,43,59,83,19,16,86
08X312,2004,94,59,31,0,6,2,18,20,3,0,0,38,56,66,28,16,78
08X312,2003,43,36,15,0,1,0,38,67,2,0,1,17,26,30,13,5,38
08X320,2017,119,83,83,13,13,12,35,71,0,1,0,58,61,89,30,20,99
08X320,2016,106,76,66,6,12,9,28,54,11,3,1,47,59,85,21,18,88
08X320,2015,108,69,47,5,20,5,17,71,11,3,1,50,58,68,40,29,79
08X320,2014,108,68,58,6,13,10,21,63,11,3,0,46,62,90,18,20,88
08X320,2013,113,76,69,11,10,12,31,56,10,4,0,48,65,86,27,26,87
08X332,2014,31,23,14,0,1,3,23,39,1,1,1,16,15,28,3,10,21
08X332,2013,31,16,13,0,7,1,41,42,0,1,0,26,39,25,6,8,23
08X332,2012,65,36,27,0,8,1,33,50,2,3,0,41,33,61,4,20,45
08X332,2011,74,44,38,0,12,2,43,57,1,1,0,29,39,64,10,15,59
08X332,2010,68,30,27,0,10,1,34,52,1,1,0,40,45,61,7,14,54
08X332,2009,85,38,34,0,15,0,2,0,0,0,0,47,42,78,7,12,73
08X332,2008,89,43,41,0,19,0,2,2,1,0,0,56,48,75,14,9,80
08X332,2007,104,54,44,2,18,0,24,39,2,0,0,50,39,86,18,7,97
08X332,2006,89,51,36,0,13,0,30,42,0,2,0,0,2,81,8,10,79
08X348,2017,101,83,82,4,8,6,27,65,2,0,1,48,53,83,18,21,80
08X348,2016,113,81,70,1,18,12,38,52,9,2,0,38,75,90,23,24,89
08X348,2015,98,63,47,0,11,5,31,47,12,1,2,40,58,68,30,25,73
08X348,2014,99,76,60,0,2,5,25,62,6,0,1,47,52,78,21,19,80
08X348,2013,69,43,36,0,7,2,9,52,4,2,0,37,32,50,19,12,57
08X349,2017,100,76,76,12,11,7,29,54,7,3,0,39,61,75,25,21,79
08X349,2016,116,89,89,8,15,7,22,71,14,2,0,48,68,92,24,34,82
08X349,2015,96,69,52,2,21,8,17,66,4,1,0,52,44,77,19,21,75
08X349,2014,105,77,68,1,9,6,26,63,6,4,0,46,59,80,25,24,81
08X349,2013,91,61,56,0,6,1,29,52,5,4,0,53,38,55,36,15,76
08X367,2017,79,51,51,0,10,9,19,48,2,1,0,27,52,68,11,19,60
08X367,2016,84,63,56,3,10,12,22,47,3,0,0,27,57,68,16,17,67
08X367,2015,94,59,48,2,18,8,20,62,4,0,0,32,62,70,24,24,70
08X367,2014,78,46,40,3,7,6,23,46,1,1,1,28,50,69,9,20,58
08X367,2013,95,54,45,1,5,4,36,54,1,0,0,36,59,73,22,26,69
08X367,2012,95,49,44,3,5,7,32,54,1,1,0,31,64,68,27,23,72
08X367,2011,86,47,40,0,7,6,30,47,3,0,0,27,59,70,16,26,60
08X367,2010,82,41,39,1,7,1,27,52,2,0,0,34,48,63,19,10,72
08X376,2017,60,49,49,1,4,5,16,34,3,2,0,23,37,46,14,15,45
08X376,2016,60,43,41,2,6,5,10,44,0,1,0,25,35,50,10,16,44
08X376,2015,61,40,33,4,7,3,18,39,0,1,0,33,28,48,13,14,47
08X376,2014,55,27,24,0,12,8,12,34,0,1,0,29,26,40,15,11,44
08X376,2013,55,34,30,0,8,4,14,35,1,1,0,26,29,41,14,8,47
08X376,2012,69,40,36,2,15,2,16,51,0,0,0,43,26,40,29,15,54
08X376,2011,68,42,38,4,4,2,15,51,0,0,0,31,37,41,27,18,50
08X376,2010,51,30,27,0,5,0,16,34,1,0,0,25,26,29,22,15,36
08X377,2017,56,9,9,0,5,3,17,36,0,0,0,25,31,48,8,10,46
08X377,2016,83,15,15,0,19,2,24,51,5,1,0,35,48,70,13,12,71
08X377,2015,79,6,4,0,32,1,27,49,2,0,0,35,44,69,10,9,70
08X377,2014,81,10,5,0,16,1,20,60,0,0,0,45,36,69,12,22,59
08X377,2013,77,8,6,0,11,4,29,42,2,0,0,39,38,54,23,15,62
08X377,2012,80,9,7,0,14,3,28,44,2,2,1,41,39,61,19,7,73
08X377,2011,75,13,12,0,12,4,30,55,1,0,0,44,31,53,22,5,70
08X377,2010,90,9,8,0,18,1,37,49,5,1,0,46,44,67,23,7,83
08X377,2009,93,6,6,0,20,1,33,62,2,1,0,52,41,93,0,7,86
08X377,2008,99,9,8,1,29,2,30,73,0,2,0,55,44,99,0,4,95
08X377,2007,107,15,7,0,29,0,33,41,1,0,0,55,52,105,2,8,99
08X377,2006,79,10,1,0,19,0,27,49,3,0,0,48,31,59,20,10,69
08X377,2005,98,5,2,0,13,0,32,66,0,0,0,65,33,84,14,14,84
08X377,2004,29,2,0,0,1,0,17,12,0,0,0,19,10,28,1,5,24
08X377,2003,16,0,0,0,0,0,9,7,0,0,0,7,9,12,4,2,14
08X405,2017,172,134,132,26,16,18,56,85,11,2,0,76,96,133,39,48,124
08X405,2016,157,118,118,29,15,31,34,73,17,2,0,64,93,126,31,35,122
08X405,2015,182,113,95,11,37,32,38,85,24,3,0,64,118,139,43,42,140
08X405,2014,183,93,92,17,30,29,26,105,23,0,0,74,109,143,40,46,137
08X405,2013,243,136,126,25,47,24,53,116,40,7,3,86,157,169,74,55,188
08X405,2012,348,157,144,20,91,34,83,196,33,2,0,135,213,261,87,82,266
08X405,2011,620,214,194,21,143,46,131,363,74,6,0,198,422,448,172,161,459
08X405,2010,788,375,345,62,163,65,169,472,79,3,0,342,446,520,268,185,603
08X405,2009,908,424,402,83,186,66,206,554,76,6,0,359,549,586,322,185,723
08X405,2008,932,419,390,93,181,62,204,583,78,5,0,379,553,597,335,186,746
08X405,2007,982,453,369,95,227,63,205,591,119,4,0,386,596,959,23,184,798
08X405,2006,1092,487,386,137,232,68,260,647,112,3,2,460,632,1035,57,172,920
08X405,2005,1007,458,340,122,146,66,216,585,132,4,4,404,603,965,42,188,819
08X405,2004,1059,453,299,132,205,72,246,593,141,2,5,506,553,789,270,189,870
08X405,2003,890,413,273,97,152,58,199,473,148,6,6,407,483,571,319,138,752
08X405,2002,910,429,282,76,115,66,204,472,145,23,0,435,475,533,377,65,845
08X405,2001,922,511,299,88,124,68,210,443,183,18,0,459,463,517,405,124,798
08X432,2017,102,91,91,3,7,9,7,84,1,1,0,54,48,88,14,11,91
08X432,2016,90,77,76,17,10,12,2,67,6,3,0,44,46,86,4,13,77
08X432,2015,93,61,56,7,14,10,3,74,4,2,0,37,56,79,14,8,85
08X432,2014,85,53,47,4,12,8,3,73,1,0,0,40,45,74,11,8,77
08X432,2013,73,34,28,1,13,9,0,61,2,1,0,29,44,56,17,8,65
08X432,2012,80,37,33,1,11,8,9,59,1,3,0,41,39,46,34,9,71
08X432,2011,86,42,37,0,8,6,7,70,3,0,0,38,48,57,29,13,73
08X432,2010,68,40,38,0,0,3,7,57,0,1,0,39,29,53,15,9,59
08X450,2006,7,0,0,0,1,7,81,171,4,0,0,4,3,5,2,75,188
08X450,2005,263,87,38,6,98,5,124,220,5,2,1,128,135,185,78,78,279
08X450,2004,357,77,29,0,122,19,213,370,4,2,4,169,188,234,123,149,463
08X450,2003,612,177,71,0,167,15,262,339,6,1,0,322,290,393,219,78,545
08X450,2002,623,185,93,0,132,17,234,397,5,3,0,328,295,487,136,114,542
08X450,2001,656,195,92,0,166,0,4,3,0,0,0,339,317,558,98,7,0
08X452,2017,143,88,88,0,27,8,47,86,1,1,0,61,82,127,16,36,107
08X452,2016,158,107,106,6,23,14,47,96,1,0,0,69,89,130,28,42,116
08X452,2015,157,74,49,0,27,12,51,88,4,2,0,69,88,137,20,46,111
08X452,2014,145,74,51,0,16,11,41,87,1,4,1,52,93,124,21,49,96
08X452,2013,63,39,27,0,9,3,18,40,0,1,1,33,30,46,17,17,46
08X452,2012,70,47,39,0,13,1,20,46,2,1,0,26,44,47,23,22,48
08X452,2011,61,35,25,0,13,2,21,38,0,0,0,31,30,45,16,18,43
08X452,2010,72,38,19,0,10,2,18,51,0,0,1,42,30,52,20,27,45
08X452,2009,88,38,31,0,4,6,33,48,1,0,0,48,40,88,0,21,67
08X452,2008,61,36,32,0,5,3,29,29,0,0,0,30,31,61,0,12,49
08X452,2007,85,56,33,0,14,4,23,35,1,1,0,44,41,80,5,20,65
08X452,2006,64,40,0,0,4,1,17,25,0,0,0,37,27,63,1,14,50
08X452,2005,43,23,3,0,7,1,38,38,4,0,0,23,20,42,1,9,34
08X452,2004,81,47,9,0,7,1,33,45,0,1,0,43,38,79,2,22,59
08X452,2003,62,30,0,0,7,0,29,55,1,0,0,25,37,50,12,10,52
08X452,2002,80,44,0,0,1,0,29,33,0,0,0,47,33,54,26,6,74
08X519,2015,8,0,0,0,8,2,28,52,2,2,1,2,6,7,1,3,5
08X519,2014,61,15,11,1,19,1,22,69,1,1,0,30,31,60,1,13,48
08X519,2013,80,29,23,0,21,1,21,59,2,1,0,42,38,65,15,26,54
08X519,2012,87,39,26,1,16,1,26,78,0,0,1,39,48,79,8,33,54
08X519,2011,94,37,32,0,24,3,25,87,0,0,1,52,42,77,17,22,72
08X519,2010,84,32,31,1,22,2,19,59,0,1,0,46,38,72,12,23,61
08X519,2009,106,39,35,0,28,0,1,3,0,0,0,59,47,65,41,21,85
08X519,2008,116,68,61,2,13,0,2,6,0,0,0,68,48,83,33,23,93
08X519,2007,81,43,26,0,11,0,8,50,2,1,0,51,30,66,15,15,66
08X519,2006,99,52,31,0,17,0,25,73,0,1,0,61,38,80,19,21,78
08X519,2005,95,52,30,0,10,0,25,69,1,0,0,59,36,67,28,10,85
08X519,2004,102,46,22,0,20,0,46,56,0,0,0,60,42,85,17,13,89
08X519,2003,9,0,0,0,3,0,4,5,0,0,0,2,7,7,2,2,7
08X530,2017,85,64,63,5,8,1,20,37,0,0,2,39,46,81,4,25,60
08X530,2016,60,38,34,0,9,1,14,36,0,1,0,25,35,51,9,20,40
08X530,2015,76,41,37,0,13,1,46,59,0,0,0,33,43,68,8,19,57
08X530,2014,47,28,16,0,12,1,27,78,0,0,0,23,24,42,5,24,23
08X530,2013,52,24,17,0,19,1,36,86,0,0,0,22,30,43,9,16,36
08X530,2012,92,41,32,0,24,1,26,87,2,1,0,38,54,73,19,25,67
08X530,2011,106,45,34,0,21,6,35,58,0,0,0,43,63,94,12,32,74
08X530,2010,106,37,29,1,23,1,38,68,0,1,0,63,43,85,21,27,79
08X530,2009,123,39,27,0,20,1,39,73,1,0,0,52,71,90,33,33,90
08X530,2008,117,49,42,0,25,1,13,23,0,0,0,59,58,92,25,21,96
08X530,2007,99,50,34,0,18,0,33,50,1,1,0,58,41,97,2,21,78
08X530,2006,108,45,27,3,25,0,31,45,0,0,0,67,41,106,2,17,91
08X530,2005,114,59,33,0,14,0,12,34,1,0,0,68,46,112,2,17,97
08X530,2004,82,30,12,0,18,0,41,48,2,1,0,46,36,72,10,15,67
08X530,2003,65,29,19,0,9,0,24,57,1,0,0,29,36,49,16,9,56
08X530,2002,37,23,10,0,1,0,21,43,1,0,0,22,15,33,4,2,35
08X530,2001,47,40,14,0,1,0,19,27,1,0,0,25,22,46,1,6,41
08X537,2017,43,9,9,2,4,2,16,23,1,0,1,27,16,39,4,7,36
08X537,2016,55,9,9,0,4,2,27,37,1,0,0,31,24,53,2,13,42
08X537,2015,67,11,7,0,7,1,18,45,3,0,0,39,28,60,7,14,53
08X537,2014,67,11,11,0,6,2,27,40,4,0,1,36,31,61,6,2,65
08X537,2013,60,6,6,0,4,1,34,47,2,0,0,37,23,50,10,4,56
08X537,2012,74,9,9,0,9,2,17,29,0,0,0,40,34,62,12,8,66
08X537,2011,56,2,2,0,7,0,12,41,2,0,0,27,29,42,14,7,49
08X537,2010,76,8,8,1,12,0,23,37,0,0,0,47,29,58,18,5,71
08X537,2009,84,4,3,0,6,0,14,39,1,2,0,42,42,70,14,5,79
08X537,2008,48,2,1,0,4,0,28,46,1,1,0,28,20,39,9,4,44
08X540,2010,19,8,8,0,7,1,9,9,0,0,0,10,9,13,6,4,15
08X540,2009,62,14,12,0,17,3,17,42,0,0,0,27,35,62,0,20,42
08X540,2008,79,21,19,0,24,3,22,54,0,0,0,42,37,79,0,25,54
08X540,2007,126,53,36,0,39,5,39,81,0,1,0,67,59,118,8,25,101
08X540,2006,89,44,23,1,14,2,27,59,1,0,0,48,41,76,13,20,69
08X540,2005,106,45,19,1,14,3,40,63,0,0,0,51,55,90,16,26,80
08X540,2004,89,36,13,1,13,1,39,47,1,0,1,40,49,74,15,17,72
08X540,2003,56,25,10,0,10,1,19,32,1,0,3,28,28,39,17,9,47
08X540,2002,13,0,0,0,3,0,5,8,0,0,0,6,7,11,2,1,12
08X558,2017,112,97,97,24,11,6,28,64,14,0,0,49,63,85,27,21,91
08X558,2016,131,103,103,4,12,9,31,81,10,0,0,57,74,98,33,27,104
08X558,2015,151,108,95,7,18,11,31,86,20,3,0,71,80,129,22,32,119
08X558,2014,166,121,112,16,15,9,31,102,19,2,3,81,85,134,32,28,138
08X558,2013,150,107,90,5,7,12,43,76,15,4,0,73,77,104,46,36,114
08X558,2012,98,71,61,4,5,3,30,52,10,3,0,54,44,54,44,14,84
08X559,2017,41,21,21,0,17,2,30,44,3,2,0,27,14,38,3,18,23
08X559,2016,81,27,27,0,29,1,30,63,0,0,0,47,34,69,12,24,57
08X559,2015,105,38,31,0,28,1,31,37,0,0,4,53,52,95,10,33,72
08X559,2014,94,35,32,0,16,2,27,44,0,1,0,60,34,81,13,17,77
08X559,2013,73,39,35,0,13,0,16,25,0,0,0,48,25,64,9,20,53
08X559,2012,74,53,52,0,8,0,36,65,3,1,0,45,29,61,13,10,64
08X560,2009,12,2,2,0,8,1,77,97,1,0,0,51,25,9,3,0,12
08X560,2008,76,20,16,0,14,1,62,77,0,4,0,97,79,67,9,3,73
08X560,2007,176,31,19,0,48,2,65,84,2,0,0,88,53,144,32,15,161
08X560,2006,141,28,8,0,24,1,59,82,2,0,1,80,64,123,18,18,123
08X560,2005,144,20,5,0,21,1,63,80,0,1,0,87,66,127,17,17,127
08X560,2004,153,25,5,0,10,2,90,69,1,0,0,70,75,135,18,17,136
08X560,2003,145,27,4,0,16,0,4,8,0,0,0,75,70,129,16,16,129
08X560,2002,145,20,3,0,13,0,59,81,0,1,0,87,75,105,40,11,134
08X560,2001,162,20,2,0,13,0,0,1,0,0,0,0,1,81,81,19,143
08X561,2017,102,80,80,1,6,4,20,75,2,0,1,32,70,88,14,31,71
08X561,2016,95,76,76,3,10,3,28,57,7,0,0,36,59,74,21,19,76
08X561,2015,102,79,69,0,16,4,32,63,0,2,1,28,74,78,24,23,79
08X561,2014,116,67,58,1,15,7,38,69,2,0,0,44,72,86,30,34,82
08X561,2013,105,49,42,0,14,1,37,64,2,0,1,41,64,78,27,31,74
08X561,2012,98,63,49,0,3,2,44,49,0,0,3,37,61,64,34,25,73
08X650,2011,87,48,34,0,21,4,54,91,1,1,0,64,23,72,15,26,61
08X650,2010,151,57,54,2,34,4,76,121,1,0,0,100,51,126,25,30,121
08X650,2009,202,67,57,1,37,4,86,133,1,2,0,143,59,180,22,44,158
08X650,2008,226,80,76,0,63,6,122,233,1,0,0,150,76,196,30,58,168
08X650,2007,362,137,122,10,91,8,149,254,3,1,4,255,107,308,54,62,300
08X650,2006,419,180,129,18,108,2,103,215,3,3,3,288,131,347,72,87,332
08X650,2005,329,147,105,20,85,8,120,226,0,2,2,227,102,273,56,62,267
08X650,2004,358,159,75,33,105,5,133,229,1,1,0,216,142,310,48,51,307
08X650,2003,369,171,70,34,78,6,115,220,1,1,0,240,129,274,95,66,303
08X650,2002,343,168,49,5,46,5,124,189,3,0,0,234,109,264,79,43,300
08X650,2001,321,184,77,13,46,0,24,62,0,1,0,240,81,247,74,55,266
08X686,2005,88,70,53,22,5,1,28,51,0,1,1,40,48,86,2,15,67
08X686,2004,82,46,31,0,20,2,21,46,1,0,0,50,32,79,3,29,52
08X686,2003,81,25,12,0,25,0,1,0,0,0,0,36,45,72,9,20,50
08X686,2002,70,28,19,0,11,0,30,50,0,0,1,27,43,61,9,20,54
08X686,2001,74,20,4,0,18,0,21,52,1,0,0,35,39,62,12,1,0
09X227,2017,86,76,76,24,5,5,15,64,1,1,0,43,43,76,10,15,71
09X227,2016,87,70,70,17,9,5,30,51,1,0,0,45,42,76,11,23,64
09X227,2015,101,76,72,12,9,3,20,66,0,0,1,52,49,89,12,22,79
09X227,2014,90,68,57,4,7,1,36,55,1,0,0,45,45,71,19,21,69
09X227,2013,93,59,53,4,17,1,30,67,0,0,0,34,59,60,33,25,68
09X227,2012,87,40,39,4,22,1,27,67,0,0,0,39,48,61,26,24,63
09X227,2011,100,50,45,3,19,2,21,56,0,1,0,46,54,68,32,21,79
09X227,2010,98,47,46,7,25,0,19,79,2,0,1,46,52,79,19,21,77
09X227,2009,95,45,38,4,30,0,28,59,0,0,0,47,48,95,0,22,73
09X227,2008,91,47,45,4,29,0,29,68,1,2,0,51,40,91,0,16,75
09X227,2007,91,41,36,0,24,0,28,60,0,3,0,45,46,88,3,21,70
09X227,2006,96,55,32,1,8,0,24,64,2,1,0,37,59,85,11,17,79
09X227,2005,94,47,20,0,11,0,33,60,3,0,0,53,41,91,3,16,78
09X227,2004,80,41,18,1,7,0,35,58,0,1,0,45,35,64,16,11,69
09X227,2003,7,1,1,0,4,0,3,4,0,0,0,4,3,6,1,1,6
09X231,2017,71,49,49,0,7,1,39,27,1,0,0,0,71,60,11,16,55
09X231,2016,68,57,57,0,5,1,45,36,0,0,0,0,68,51,17,15,53
09X231,2015,66,45,43,0,9,1,48,21,1,1,1,0,66,50,16,13,53
09X231,2014,82,55,49,0,12,3,76,28,0,0,0,0,82,59,23,22,60
09X231,2013,73,46,39,0,7,2,69,29,0,0,0,0,73,50,23,23,50
09X231,2012,80,62,55,0,5,0,35,33,1,2,0,0,80,64,16,25,55
09X231,2011,105,67,60,2,7,0,40,26,0,0,0,0,105,75,30,29,76
09X231,2010,105,65,57,9,9,0,48,27,0,0,5,0,105,84,21,20,85
09X231,2009,80,49,44,0,12,0,74,30,0,1,0,0,80,58,22,23,57
09X231,2008,107,75,72,6,6,0,74,27,3,0,1,0,107,76,31,25,82
09X231,2007,117,82,69,6,6,0,47,32,0,1,0,0,117,82,35,19,98
09X231,2006,100,63,47,0,4,0,74,43,0,0,0,0,100,99,1,18,82
09X231,2005,85,55,34,0,5,0,61,24,0,0,0,0,85,62,23,7,78
09X231,2004,84,56,24,1,3,0,49,29,4,1,1,0,84,71,13,9,75
09X239,2010,20,18,6,0,1,1,22,19,1,1,0,0,20,14,6,8,12
09X239,2009,44,10,8,0,19,0,13,6,0,1,0,0,44,44,0,15,29
09X239,2008,61,18,13,0,16,0,32,28,0,1,0,0,61,61,0,16,45
09X239,2007,83,33,9,8,22,0,44,37,2,0,0,0,83,76,7,17,66
09X239,2006,74,31,11,0,18,0,33,40,1,0,0,0,74,43,31,16,58
09X239,2005,71,38,19,0,13,0,37,33,1,0,0,0,71,51,20,10,61
09X239,2004,70,37,7,0,8,0,42,26,2,0,0,0,70,52,18,11,59
09X241,2017,86,76,76,21,0,3,40,52,0,0,0,42,44,81,5,25,61
09X241,2016,79,65,65,30,1,1,20,52,2,1,0,41,38,73,6,20,59
09X241,2015,82,56,51,13,12,1,28,53,1,0,0,36,46,77,5,28,54
09X241,2014,94,72,62,13,2,4,21,57,3,0,0,45,49,83,11,25,69
09X241,2013,95,81,73,15,1,3,22,52,1,0,0,49,46,86,9,19,76
09X241,2012,76,61,59,17,1,5,22,56,3,1,0,34,42,62,14,17,59
09X241,2011,83,69,64,21,4,2,26,42,1,0,0,44,39,74,9,14,69
09X241,2010,85,58,53,8,8,0,27,58,0,1,0,44,41,79,6,19,66
09X241,2009,78,59,52,10,2,0,31,46,1,1,0,36,42,71,7,12,66
09X241,2008,87,79,77,17,0,0,28,54,0,0,0,39,48,87,0,11,76
09X241,2007,71,65,60,19,2,0,34,58,2,0,0,31,40,71,0,5,66
09X250,2017,105,89,89,44,5,1,39,61,0,2,2,61,44,77,28,24,81
09X250,2016,97,85,85,44,5,2,23,69,1,1,1,51,46,88,9,21,76
09X250,2015,115,88,68,9,10,2,39,73,0,0,1,55,60,98,17,34,81
09X250,2014,103,81,70,10,4,4,52,43,2,0,2,55,48,88,15,28,75
09X250,2013,105,89,74,4,1,1,44,59,0,1,0,54,51,90,15,23,82
09X250,2012,94,76,68,6,4,1,43,48,2,0,0,44,50,81,13,16,78
09X250,2011,132,109,101,17,6,1,32,40,0,0,0,68,64,120,12,27,105
09X250,2010,73,61,57,4,6,1,28,37,1,0,0,39,34,66,7,16,57
09X250,2009,67,52,51,5,6,2,27,28,0,0,0,37,30,62,5,6,61
09X250,2008,68,53,47,4,5,0,60,71,0,1,0,39,29,68,0,14,54
09X250,2007,57,38,27,4,7,0,28,40,0,0,0,29,28,56,1,8,49
09X250,2006,60,36,33,2,3,0,25,33,0,2,0,38,22,59,1,4,56
09X250,2005,53,39,30,8,2,0,32,20,0,1,0,29,24,35,18,3,50
09X252,2017,86,70,70,0,2,3,24,72,0,0,3,42,44,71,15,17,69
09X252,2016,96,83,79,0,3,1,16,72,1,0,0,47,49,90,6,19,77
09X252,2015,102,82,67,0,4,2,29,55,1,0,0,60,42,95,7,18,84
09X252,2014,102,83,72,0,7,2,37,62,0,0,0,49,53,91,11,24,78
09X252,2013,103,81,71,0,6,2,39,65,1,0,0,42,61,93,10,27,76
09X252,2012,109,81,70,1,8,3,35,65,1,0,0,58,51,94,15,21,88
09X252,2011,90,71,63,3,4,0,24,62,0,0,0,43,47,77,13,15,75
09X252,2010,84,51,47,0,7,0,22,72,1,1,0,45,39,74,10,17,67
09X252,2009,87,72,66,4,3,0,25,74,1,2,0,45,42,73,14,9,78
09X252,2008,84,66,66,2,4,0,20,81,1,0,1,49,35,84,0,6,78
09X252,2007,101,85,79,8,4,0,28,76,2,3,0,53,48,100,1,4,97
09X252,2006,107,83,81,9,2,0,23,61,0,0,0,54,53,105,2,8,99
09X252,2005,104,92,71,7,2,0,23,60,1,0,0,59,45,70,34,11,93
09X260,2017,110,100,100,48,1,8,20,76,5,0,1,65,45,90,20,16,94
09X260,2016,112,100,100,72,4,3,21,81,4,3,0,63,49,92,20,20,92
09X260,2015,109,98,91,47,3,13,27,67,1,0,1,59,50,96,13,24,85
09X260,2014,113,97,92,49,4,10,34,67,1,0,1,65,48,95,18,18,95
09X260,2013,112,99,95,44,3,7,23,80,1,0,1,66,46,85,27,12,100
09X260,2012,107,93,92,38,2,5,31,67,2,2,0,52,55,98,9,13,94
09X260,2011,111,100,96,26,3,6,29,75,1,0,0,51,60,90,21,21,90
09X260,2010,109,94,92,39,3,8,34,66,1,0,0,67,42,95,14,13,96
09X260,2009,102,93,91,49,4,9,17,76,0,0,0,49,53,83,19,10,92
09X260,2008,101,84,83,44,3,5,26,68,2,0,0,59,42,101,0,10,91
09X260,2007,99,77,73,27,4,8,20,71,0,0,0,52,47,99,0,12,87
09X260,2006,100,88,77,29,4,4,26,69,0,1,0,50,50,100,0,1,99
09X260,2005,93,73,67,26,0,8,33,49,1,2,0,48,45,68,25,3,90
09X263,2017,90,54,54,5,9,1,27,64,3,0,1,44,46,89,1,26,64
09X263,2016,86,55,52,1,14,1,32,63,1,0,0,43,43,82,4,22,64
09X263,2015,96,61,55,3,13,2,28,67,0,0,0,54,42,82,14,22,74
09X263,2014,91,51,38,0,7,2,30,55,0,0,0,50,41,80,11,26,65
09X263,2013,97,54,46,0,7,1,27,69,0,2,0,58,39,77,20,27,70
09X263,2012,97,59,50,0,11,1,37,63,1,0,0,51,46,80,17,18,79
09X263,2011,97,54,50,0,10,0,21,69,0,0,0,39,58,85,12,15,82
09X263,2010,87,47,40,0,6,0,34,51,0,1,0,51,36,78,9,21,66
09X263,2009,99,60,52,0,12,0,23,67,1,0,0,56,43,84,15,16,83
09X263,2008,102,58,53,0,13,0,28,68,1,0,0,71,31,83,19,12,90
09X263,2007,102,58,44,1,8,0,45,57,0,0,0,67,35,98,4,15,87
09X263,2006,120,90,64,1,14,0,51,68,0,1,0,88,32,119,1,11,109
09X263,2005,103,70,51,0,15,0,25,76,0,1,1,69,34,101,2,13,90
09X276,2013,47,17,14,0,22,2,25,40,0,0,0,21,25,41,6,9,38
09X276,2012,46,24,20,0,14,1,25,40,1,0,0,24,25,43,3,17,29
09X276,2011,49,14,13,0,17,1,17,42,2,0,0,30,39,42,7,6,43
09X276,2010,69,26,23,0,13,0,1,4,0,0,0,18,30,64,5,13,56
09X276,2009,48,19,17,0,11,0,13,34,0,0,0,37,30,39,9,3,45
09X276,2008,67,29,27,1,19,0,15,29,2,0,0,37,49,55,12,8,59
09X276,2007,86,50,41,2,22,0,15,31,2,0,0,32,35,74,12,19,67
09X276,2006,67,36,33,3,14,0,36,50,0,0,0,33,29,53,14,6,61
09X276,2005,62,42,26,3,15,0,0,1,0,0,0,1,0,53,9,10,52
09X297,2017,117,103,103,32,3,2,26,88,1,0,0,61,56,108,9,26,91
09X297,2016,70,57,57,12,3,1,18,49,2,0,0,39,31,69,1,15,55
09X297,2015,86,62,51,5,8,2,25,57,2,0,0,38,48,76,10,27,59
09X297,2014,90,63,51,10,10,1,27,60,1,1,0,42,48,84,6,32,58
09X297,2013,99,69,58,1,11,2,33,63,1,1,0,52,47,98,1,24,75
09X297,2012,100,63,58,5,15,1,37,100,1,1,0,54,46,90,10,26,74
09X297,2011,140,90,81,3,16,1,25,77,0,1,0,58,82,122,18,31,109
09X297,2010,91,49,43,4,10,1,38,59,1,0,0,50,41,77,14,19,72
09X297,2009,104,56,47,2,19,1,28,61,0,0,0,42,62,101,3,23,81
09X297,2008,102,59,52,1,19,1,28,34,2,0,1,57,45,102,0,18,84
09X297,2007,106,58,41,0,12,0,18,81,0,0,0,54,52,106,0,22,84
09X297,2006,99,67,36,0,15,0,22,67,1,0,1,52,47,98,1,24,75
09X297,2005,61,53,20,0,5,0,38,64,0,0,0,31,30,61,0,13,48
09X297,2004,90,62,9,0,3,0,31,74,1,0,0,49,41,90,0,20,70
09X297,2003,66,48,6,0,3,0,21,39,1,0,0,38,28,66,0,9,57
09X324,2017,66,65,62,27,0,5,10,49,0,2,0,29,37,54,12,13,53
09X324,2016,51,48,44,9,0,4,22,35,2,0,0,25,26,41,10,9,42
09X324,2015,63,63,59,17,0,2,13,46,0,0,0,35,28,49,14,3,60
09X324,2014,61,53,50,4,0,1,23,54,1,0,0,37,24,50,11,9,52
09X324,2013,79,61,52,1,1,3,22,42,1,0,0,41,38,60,19,10,69
09X324,2012,68,63,54,3,0,4,20,36,0,0,0,31,37,50,18,12,56
09X324,2011,60,56,49,4,1,3,18,38,0,0,0,32,28,54,6,9,51
09X324,2010,59,50,44,4,1,1,23,53,1,0,0,30,29,53,6,9,50
09X324,2009,78,69,69,14,1,0,18,30,2,1,0,36,42,63,15,3,75
09X327,2017,107,94,94,20,1,1,23,83,0,0,0,53,54,95,12,32,75
09X327,2016,98,84,84,29,2,2,23,87,0,0,0,54,44,87,11,29,69
09X327,2015,120,104,91,22,5,0,16,80,2,0,0,61,59,112,8,30,90
09X327,2014,104,87,78,28,4,0,28,90,2,0,0,48,56,92,12,23,81
09X327,2013,112,93,91,18,5,0,29,74,1,0,0,48,64,91,21,24,88
09X327,2012,111,91,88,31,5,0,26,83,2,0,0,56,55,106,5,19,92
09X329,2017,50,43,43,0,2,1,16,33,0,0,0,30,20,42,8,12,38
09X329,2016,43,33,33,2,2,4,26,38,0,1,0,30,13,39,4,5,38
09X329,2015,64,44,40,2,14,1,23,60,0,0,0,35,29,54,10,14,50
09X329,2014,76,37,31,0,24,0,11,32,0,0,0,40,36,59,17,21,55
09X329,2013,78,50,39,0,14,0,18,45,0,1,0,48,30,56,22,24,54
09X329,2012,69,39,36,0,22,0,24,51,0,0,1,43,26,53,16,11,58
09X329,2011,87,51,46,0,13,0,33,42,2,1,0,52,35,65,22,19,68
09X329,2010,87,35,32,0,27,0,20,57,1,9,0,48,39,63,24,19,68
09X329,2009,84,25,23,4,36,0,19,65,2,1,0,42,42,83,1,19,65
09X329,2008,91,39,38,2,26,0,32,58,0,1,0,54,37,91,0,11,80
09X329,2007,90,35,27,0,17,0,29,61,0,0,0,58,32,88,2,12,78
09X329,2006,93,40,29,3,15,0,43,48,1,0,1,46,47,76,17,8,85
09X350,2017,60,21,21,0,21,2,15,40,2,1,0,22,38,53,7,8,52
09X350,2016,55,15,12,0,24,2,17,43,0,0,0,23,32,51,4,19,36
09X350,2015,62,5,4,0,30,0,10,44,0,1,0,24,38,55,7,16,46
09X350,2014,20,2,2,0,10,0,2,18,0,0,0,10,10,19,1,3,17
09X365,2017,77,77,77,38,0,0,1,76,0,0,0,40,37,77,0,7,70
09X365,2016,65,63,63,18,0,0,1,85,0,0,0,25,40,64,1,4,61
09X365,2015,73,72,67,2,0,0,0,77,0,0,0,40,33,73,0,9,64
09X365,2014,75,72,71,10,0,0,0,65,0,0,0,23,52,72,3,9,66
09X365,2013,76,73,72,8,1,0,0,73,0,0,0,28,48,73,3,5,71
09X365,2012,73,68,68,0,5,0,0,75,0,0,0,33,40,71,2,3,70
09X365,2011,70,65,64,2,3,0,0,76,0,0,0,34,36,67,3,5,65
09X365,2010,77,70,68,0,7,0,0,73,0,0,0,40,37,71,6,3,74
09X365,2009,86,72,70,0,9,0,0,70,0,0,0,39,47,82,4,2,84
09X365,2008,84,62,62,7,10,0,0,84,0,0,0,51,33,72,12,0,84
09X365,2007,90,61,43,3,5,0,0,90,0,0,0,45,45,80,10,0,90
09X403,2017,98,83,83,0,1,6,10,79,3,0,0,45,53,92,6,4,94
09X403,2016,100,85,85,0,8,1,14,79,5,1,0,51,49,92,8,4,96
09X403,2015,96,61,58,0,9,2,13,79,1,1,0,65,31,89,7,3,93
09X403,2014,97,54,46,0,6,4,17,76,0,0,0,47,50,91,6,8,89
09X403,2013,81,63,58,0,1,4,18,55,3,1,0,39,42,77,4,5,76
09X403,2012,83,60,60,0,6,2,20,61,0,0,0,41,42,83,0,6,77
09X403,2011,115,81,76,0,4,4,27,81,1,2,0,64,51,108,7,7,108
09X403,2010,107,68,66,0,6,1,19,66,3,0,0,59,48,101,6,11,96
09X403,2009,89,42,41,0,9,3,20,62,3,0,0,42,47,84,5,5,84
09X403,2008,83,52,47,0,5,2,16,41,0,0,2,46,37,83,0,2,81
09X403,2007,104,61,36,0,4,2,15,45,4,0,0,54,50,103,1,5,99
09X403,2006,88,58,28,0,4,2,14,45,0,0,0,41,47,84,4,10,78
09X403,2005,61,45,22,1,7,3,17,28,2,0,0,29,32,60,1,6,55
09X403,2004,66,45,21,0,3,0,30,77,0,0,0,34,32,66,0,7,59
09X403,2003,61,29,7,0,1,0,24,52,7,0,0,38,23,59,2,5,56
09X403,2002,50,28,11,0,6,0,19,81,4,0,0,28,22,24,26,1,49
09X403,2001,41,21,21,0,0,0,11,28,2,0,0,25,16,32,9,1,40
09X404,2017,85,49,49,0,20,1,28,55,0,1,0,39,46,79,6,21,64
09X404,2016,63,23,23,0,13,2,23,69,0,0,0,27,36,53,10,17,46
09X404,2015,94,45,43,0,19,1,26,55,3,1,0,43,51,78,16,28,66
09X404,2014,86,52,51,0,2,1,20,60,0,0,0,37,49,79,7,21,65
09X404,2013,95,49,47,0,12,2,41,49,0,0,0,37,58,83,12,25,70
09X404,2012,81,44,42,0,10,3,29,33,0,0,2,37,44,70,11,26,55
09X404,2011,97,52,47,0,10,1,29,36,2,0,0,51,46,85,12,29,68
09X404,2010,92,41,37,0,15,0,16,45,1,1,0,49,43,78,14,24,68
09X404,2009,93,46,46,0,13,0,23,70,1,1,0,47,46,89,4,13,80
09X404,2008,110,52,51,0,20,0,28,68,0,1,0,50,60,110,0,34,76
09X404,2007,125,74,55,0,26,0,28,62,0,2,0,62,63,124,1,28,97
09X404,2006,108,59,32,0,10,0,33,60,0,0,0,52,56,108,0,20,88
09X404,2005,83,64,24,0,10,0,38,72,0,0,0,43,40,83,0,8,75
09X404,2004,92,69,21,0,7,0,50,74,1,0,0,54,38,92,0,13,79
09X404,2003,67,45,16,0,2,0,45,61,0,2,0,33,34,67,0,6,61
09X404,2002,68,47,16,0,1,0,36,45,2,0,0,43,25,67,1,9,59
09X404,2001,57,40,10,0,3,0,21,35,1,0,0,38,19,52,5,5,52
09X412,2017,63,51,51,2,5,1,13,44,2,0,3,23,40,57,6,17,46
09X412,2016,53,36,36,0,7,3,10,38,2,0,0,19,34,51,2,11,42
09X412,2015,58,32,29,1,9,2,12,43,1,0,0,28,30,56,2,12,46
09X412,2014,66,38,31,0,17,1,16,48,1,0,0,35,31,55,11,16,50
09X412,2013,54,31,27,0,11,1,26,35,1,1,0,20,34,28,26,11,43
09X412,2012,64,30,28,2,13,1,33,56,0,0,0,24,40,46,18,21,43
09X412,2011,90,34,32,1,13,1,37,66,1,0,1,47,43,69,21,23,67
09X412,2010,106,40,37,1,15,2,38,60,0,0,0,41,65,79,27,22,84
09X412,2009,100,39,35,0,13,1,40,63,1,0,0,50,50,100,0,16,84
09X412,2008,105,38,36,7,23,5,38,79,0,0,0,48,57,104,1,24,81
09X412,2007,122,56,50,3,13,2,30,68,1,1,0,57,65,117,5,26,96
09X412,2006,110,54,38,13,18,2,41,61,2,2,0,45,65,84,26,25,85
09X412,2005,102,66,48,20,28,2,24,45,0,0,0,57,45,70,32,18,84
09X412,2004,108,49,41,13,18,0,12,41,0,1,0,62,46,83,25,12,96
09X412,2003,112,22,15,7,26,0,44,65,0,1,0,46,66,75,37,23,89
09X412,2002,71,37,27,8,8,0,40,69,0,1,2,41,30,59,12,5,66
09X412,2001,7,0,0,0,2,0,1,6,0,0,0,3,4,6,1,2,5
09X413,2017,70,56,56,0,0,5,16,47,1,1,0,37,33,61,9,16,54
09X413,2016,77,67,67,4,4,6,16,52,1,2,0,52,25,67,10,15,62
09X413,2015,67,57,54,0,4,7,21,37,1,0,1,35,32,55,12,9,58
09X413,2014,68,50,45,0,4,8,17,39,1,2,1,39,29,53,15,9,59
09X413,2013,66,59,59,11,1,7,20,39,0,0,0,38,28,35,31,5,61
09X413,2012,78,73,73,16,1,3,32,41,0,1,1,40,38,51,27,5,73
09X413,2011,86,72,72,12,2,3,43,38,1,1,0,54,32,48,38,4,82
09X413,2010,65,52,52,10,1,6,19,40,0,0,0,36,29,50,15,3,62
09X413,2009,73,62,62,12,2,10,34,29,0,0,0,45,28,73,0,2,71
09X413,2008,66,60,60,9,1,6,33,24,0,3,0,47,19,66,0,1,65
09X413,2007,70,54,46,18,2,7,26,35,1,1,0,58,12,66,4,5,65
09X413,2006,103,86,73,25,1,11,57,35,0,0,0,67,36,84,19,5,98
09X413,2005,72,69,60,20,1,5,34,31,2,0,0,51,21,61,11,3,69
09X413,2004,84,70,56,14,2,12,34,36,1,1,0,57,27,55,29,4,80
09X413,2003,131,97,55,0,13,4,60,65,1,1,0,93,38,79,52,14,117
09X413,2002,65,45,15,0,6,2,18,44,0,1,0,37,28,33,32,3,62
09X414,2012,38,15,13,0,6,2,15,67,1,0,0,17,21,27,11,5,33
09X414,2011,85,35,28,1,17,1,21,75,1,0,0,39,46,66,19,27,58
09X414,2010,98,18,18,0,20,1,21,40,0,0,0,40,58,68,30,20,78
09X414,2009,109,25,23,1,21,4,33,34,0,2,0,63,46,109,0,16,93
09X414,2008,94,26,25,2,21,1,29,45,0,1,0,47,47,93,1,20,74
09X414,2007,132,49,40,3,13,2,27,25,1,0,0,70,62,132,0,21,111
09X414,2006,123,56,38,1,5,0,11,27,0,0,0,61,62,99,24,24,99
09X414,2005,62,48,30,0,2,0,30,78,1,0,0,32,30,52,10,9,53
09X414,2004,73,42,25,0,3,0,25,65,3,1,0,35,38,45,28,12,61
09X414,2003,76,24,15,0,18,0,33,97,2,0,0,27,49,53,23,17,59
09X414,2002,55,35,15,0,5,0,38,84,1,0,0,33,22,39,16,5,50
09X414,2001,6,0,0,0,4,0,2,4,0,0,0,5,1,5,1,0,6
09X505,2017,115,92,92,38,1,1,25,86,2,1,0,69,46,102,13,25,90
09X505,2016,113,103,103,35,5,1,26,83,3,0,0,62,51,96,17,22,91
09X505,2015,128,99,90,18,7,4,34,89,1,0,0,70,58,107,21,21,107
09X505,2014,132,112,111,15,8,2,40,88,0,1,1,74,58,118,14,25,107
09X505,2013,119,95,87,12,10,3,26,87,1,0,2,61,58,107,12,25,94
09X505,2012,86,66,62,5,7,1,17,63,1,1,3,53,33,77,9,12,74
09X505,2011,126,90,84,0,8,3,32,89,2,0,0,61,65,109,17,22,104
09X505,2010,132,96,93,4,6,1,41,87,3,0,0,79,53,106,26,20,112
09X505,2009,111,88,86,0,9,4,44,54,2,1,0,67,44,91,20,16,95
09X505,2008,105,71,70,6,9,3,39,55,2,0,0,53,52,105,0,9,96
09X505,2007,99,65,49,1,13,4,41,74,1,1,1,64,35,98,1,13,86
09X505,2006,122,94,70,4,5,4,33,59,2,0,0,73,49,121,1,17,105
09X505,2005,98,66,45,4,5,3,57,63,2,2,0,59,39,77,21,18,80
09X505,2004,127,87,60,5,15,0,35,76,0,0,0,87,40,101,26,15,112
09X505,2003,115,79,41,6,9,0,44,62,6,0,3,70,45,82,33,8,107
09X505,2002,72,45,32,2,12,0,37,35,0,0,0,48,24,57,15,5,67
09X505,2001,43,29,18,1,3,0,23,19,1,0,0,31,12,31,12,4,39
09X517,2017,98,66,66,8,17,4,39,51,2,2,0,35,63,90,8,27,71
09X517,2016,108,78,78,2,20,2,58,48,0,2,0,56,52,94,14,19,89
09X517,2015,106,62,59,5,22,2,43,39,1,0,0,52,54,93,13,22,84
09X517,2014,112,44,41,1,25,1,50,37,1,0,0,43,69,92,20,23,89
09X517,2013,104,65,57,0,12,2,44,41,0,0,0,46,58,90,14,21,83
09X517,2012,90,48,44,0,15,2,46,18,0,0,0,44,46,72,18,24,66
09X517,2011,110,67,67,1,16,0,57,51,0,0,0,57,53,88,22,18,92
09X517,2010,85,55,49,2,15,0,34,67,2,2,1,41,44,69,16,16,69
09X517,2009,83,50,48,9,13,0,44,59,4,2,3,42,41,71,12,11,72
09X517,2008,79,52,50,0,9,0,43,58,2,0,1,33,46,64,15,11,68
09X517,2007,89,63,42,3,5,0,50,40,0,0,0,47,42,67,22,10,79
09X517,2006,87,68,45,0,1,0,52,31,0,0,0,47,40,63,24,15,72
09X517,2005,69,53,32,1,1,0,46,33,0,0,0,39,30,34,35,0,69
09X517,2004,66,58,37,1,3,0,43,26,0,0,0,37,29,43,23,3,63
09X525,2017,123,97,97,0,22,1,44,76,1,1,0,61,62,109,14,38,85
09X525,2016,110,74,72,0,18,2,46,88,2,1,1,42,68,101,9,32,78
09X525,2015,140,77,61,0,39,1,45,96,0,1,2,70,70,117,23,34,106
09X525,2014,140,78,63,0,22,4,79,106,0,3,0,77,63,113,27,42,98
09X525,2013,145,78,63,0,28,2,88,96,0,1,0,61,84,126,19,44,101
09X525,2012,174,104,96,0,26,1,82,78,4,1,0,86,88,144,30,37,137
09X525,2011,169,90,81,0,15,1,87,90,0,0,0,83,86,133,36,41,128
09X525,2010,185,98,85,1,18,3,58,95,0,0,0,94,91,157,28,42,143
09X525,2009,192,102,90,8,41,2,61,77,2,1,0,104,88,167,25,38,154
09X525,2008,187,126,120,17,17,2,69,86,1,1,20,118,69,162,25,27,160
09X525,2007,166,106,88,1,25,1,61,76,6,1,0,87,79,122,44,30,136
09X525,2006,178,122,94,16,33,4,68,51,11,2,0,105,73,138,40,26,152
09X525,2005,156,94,59,13,14,0,24,84,2,0,0,94,62,156,0,26,130
09X525,2004,143,89,57,3,13,0,37,97,4,1,1,93,50,143,0,21,122
09X525,2003,179,110,59,3,20,0,62,106,3,1,2,106,73,179,0,30,149
09X525,2002,145,99,50,4,17,0,64,103,0,2,0,95,50,145,0,11,134
09X525,2001,136,103,1,1,11,0,80,103,0,2,0,91,45,129,7,18,118
09X543,2017,64,50,50,0,8,1,16,45,2,0,0,42,22,59,5,17,47
09X543,2016,61,38,35,0,8,1,31,44,0,0,0,46,15,55,6,18,43
09X543,2015,60,35,29,0,17,1,17,29,0,0,0,46,14,58,2,10,50
09X543,2014,98,62,40,0,6,0,20,41,0,0,0,75,23,91,7,23,75
09X543,2013,76,50,35,0,5,0,18,41,1,0,0,67,9,67,9,20,56
09X543,2012,69,43,32,0,7,0,30,68,0,0,0,54,15,62,7,22,47
09X543,2011,108,63,55,0,13,0,22,47,0,0,0,92,16,101,7,25,83
09X543,2010,68,42,34,0,11,0,42,66,0,0,0,57,11,65,3,23,45
09X543,2009,53,20,19,1,7,0,23,45,0,0,0,45,8,47,6,11,42
09X543,2008,49,32,30,0,7,0,20,33,0,0,0,44,5,40,9,12,37
09X543,2007,50,33,26,1,6,0,19,30,0,0,0,42,8,41,9,9,41
09X543,2006,47,37,32,6,2,0,20,29,0,1,0,41,6,42,5,9,38
09X543,2005,39,32,26,2,5,0,13,34,0,0,0,37,2,39,0,5,34
09X543,2004,48,38,17,0,3,0,21,18,0,0,0,44,4,48,0,10,38
09X543,2003,47,31,22,0,5,0,17,29,2,0,0,41,6,47,0,6,41
09X543,2002,44,29,7,0,2,0,16,28,0,0,0,37,7,43,1,4,40
09X564,2017,83,72,72,0,3,3,25,50,5,0,0,40,43,83,0,10,73
09X564,2016,75,62,61,0,6,9,9,55,2,0,0,45,30,75,0,6,69
09X564,2015,83,65,52,0,6,11,22,45,5,0,0,45,38,83,0,7,76
09X564,2014,88,53,45,0,11,4,23,59,1,1,0,46,42,81,7,6,82
09X564,2013,95,53,50,0,9,8,16,71,0,0,0,46,49,71,24,5,90
09X564,2012,67,44,41,0,5,4,21,41,1,0,0,30,37,61,6,3,64
09X568,2017,62,57,57,35,2,2,23,35,0,1,1,62,0,53,9,14,48
09X568,2016,67,63,63,35,2,3,20,43,0,0,1,67,0,55,12,10,57
09X568,2015,64,57,53,14,2,1,28,33,1,1,0,64,0,52,12,11,53
10X141,2017,188,169,168,94,8,14,19,104,51,0,0,86,102,128,60,28,160
10X141,2016,163,147,145,66,3,11,13,94,43,1,1,78,85,84,79,25,138
10X141,2015,161,143,126,54,5,15,16,88,40,0,2,79,82,82,79,36,125
10X141,2014,192,161,146,46,9,15,20,113,44,0,0,100,92,104,88,44,148
10X141,2013,157,141,133,45,5,15,16,96,29,0,1,69,88,75,82,26,131
10X141,2012,148,127,117,32,9,7,22,72,44,1,2,60,88,78,70,27,121
10X141,2011,157,125,119,29,14,14,17,91,34,1,0,72,85,81,76,28,129
10X141,2010,149,117,111,22,1,13,26,71,38,1,0,79,70,76,73,16,133
10X141,2009,162,122,114,23,9,13,24,93,31,0,1,83,79,82,80,19,143
10X141,2008,150,119,111,15,12,13,21,78,37,1,0,66,84,62,88,27,123
10X141,2007,160,138,122,23,7,14,18,78,48,2,0,81,79,56,104,18,142
10X141,2006,135,117,104,18,5,18,20,53,44,0,0,61,74,134,1,7,128
10X141,2005,135,105,78,17,6,13,23,60,38,1,0,67,68,135,0,19,116
10X141,2004,140,114,86,25,4,15,18,71,36,0,0,73,67,136,4,16,124
10X141,2003,93,79,61,15,2,12,10,44,27,0,0,39,54,49,44,11,82
10X141,2002,130,106,47,9,3,14,18,82,16,0,0,64,66,120,10,19,111
10X141,2001,89,70,35,0,2,7,12,59,11,0,0,51,38,86,3,11,78
10X213,2017,81,64,64,13,4,1,25,51,3,1,0,14,67,77,4,21,60
10X213,2016,106,67,67,4,18,5,26,73,0,2,0,21,85,99,7,24,82
10X213,2015,97,61,51,2,4,4,29,59,3,1,1,15,82,90,7,27,70
10X213,2014,94,62,52,9,17,3,28,54,6,1,2,16,78,81,13,22,72
10X213,2013,80,59,50,0,10,5,25,50,0,0,0,10,70,72,8,15,65
10X213,2012,90,67,59,3,10,9,28,53,0,0,0,25,65,76,14,16,74
10X213,2011,92,62,58,7,10,8,34,48,1,0,1,16,76,78,14,23,69
10X213,2010,101,52,47,6,15,2,28,70,0,1,0,17,84,78,23,19,82
10X213,2009,106,69,66,9,9,6,28,72,0,0,0,23,83,85,21,26,80
10X213,2008,112,67,64,10,7,3,35,72,2,0,0,23,89,93,19,25,87
10X213,2007,97,63,51,18,10,8,43,43,3,0,0,17,80,81,16,15,82
10X213,2006,73,55,44,11,4,5,21,45,2,0,0,13,60,63,10,10,63
10X213,2005,76,57,43,22,9,4,30,42,0,0,0,23,53,66,10,9,67
10X213,2004,62,55,54,7,2,3,21,36,1,1,0,16,46,54,8,4,58
10X225,2017,71,58,58,10,8,2,9,57,3,0,0,54,17,56,15,16,55
10X225,2016,87,66,66,5,12,1,25,60,1,0,0,58,29,68,19,19,68
10X225,2015,82,65,58,2,4,1,26,54,1,0,0,60,22,59,23,25,57
10X225,2014,88,61,57,0,5,1,27,57,0,2,1,61,27,65,23,22,66
10X225,2013,70,51,44,0,8,2,14,60,0,0,2,52,18,50,20,11,59
10X225,2012,78,59,55,0,5,1,39,53,1,0,0,53,25,49,29,12,66
10X225,2011,94,71,70,0,2,1,20,53,1,1,0,65,29,58,36,20,74
10X225,2010,66,47,45,0,2,3,14,65,3,0,0,46,20,42,24,11,55
10X225,2009,76,58,53,0,5,4,15,38,5,0,0,48,28,76,0,13,63
10X225,2008,60,49,48,3,3,0,18,48,1,2,1,44,16,60,0,6,54
10X225,2007,85,72,58,28,3,0,22,44,0,0,0,53,32,84,1,12,73
10X225,2006,62,58,49,13,1,0,14,44,1,1,0,35,27,38,24,9,53
10X225,2005,71,65,53,4,1,0,22,45,3,1,0,47,24,42,29,1,70
10X237,2017,93,76,76,7,2,3,23,65,2,0,0,63,30,74,19,14,79
10X237,2016,107,62,62,1,11,2,37,63,2,2,1,82,25,88,19,25,82
10X237,2015,119,77,65,0,10,4,37,70,4,4,0,87,32,90,29,23,96
10X237,2014,125,75,62,0,16,4,38,74,7,2,0,100,25,99,26,26,99
10X237,2013,127,70,66,0,16,2,43,74,7,0,1,95,32,83,44,23,104
10X237,2012,123,88,79,6,8,5,47,66,3,0,2,100,23,73,50,23,100
10X237,2011,138,92,88,7,8,5,53,71,6,3,0,119,19,85,53,24,114
10X237,2010,121,78,76,3,5,1,46,70,3,1,0,108,13,71,50,19,102
10X237,2009,127,82,76,5,5,1,40,75,7,4,0,102,25,127,0,21,106
10X237,2008,97,74,70,2,0,2,22,48,0,0,0,80,17,97,0,13,84
10X237,2007,79,44,36,0,8,2,42,36,1,1,0,59,20,77,2,20,59
10X237,2006,67,49,36,0,3,0,34,58,3,2,0,60,7,55,12,12,55
10X237,2005,72,65,49,1,2,0,23,52,4,0,0,64,8,68,4,4,68
10X237,2004,82,73,55,0,1,0,31,33,3,0,0,71,11,71,11,3,79
10X243,2017,61,61,61,29,0,2,8,49,2,0,0,29,32,56,5,13,48
10X243,2016,64,59,58,13,1,1,8,55,0,0,0,31,33,59,5,15,49
10X243,2015,70,56,41,8,3,1,9,58,2,0,0,34,36,66,4,18,52
10X243,2014,77,65,52,3,6,2,17,56,1,1,0,31,46,73,4,23,54
10X243,2013,63,54,47,1,5,2,9,47,5,0,0,23,40,57,6,15,48
10X243,2012,68,59,53,2,2,1,15,48,2,2,0,33,35,63,5,15,53
10X243,2011,80,62,58,4,4,3,18,58,1,0,0,34,46,77,3,16,64
10X243,2010,70,46,42,1,7,4,22,42,1,1,0,29,41,65,5,17,53
10X243,2009,82,51,50,5,8,3,21,55,0,3,0,29,53,73,9,15,67
10X243,2008,70,45,41,1,10,5,16,48,0,1,0,27,43,61,9,11,59
10X243,2007,72,39,33,0,7,4,25,42,1,0,0,23,49,61,11,15,57
10X243,2006,72,35,28,2,12,1,24,47,0,0,0,37,35,61,11,15,57
10X243,2005,72,37,15,0,8,1,32,38,0,0,1,39,33,65,7,8,64
10X243,2004,73,21,9,0,16,1,27,43,2,0,0,33,40,62,11,7,66
10X264,2017,81,64,64,4,3,7,24,45,4,1,0,17,64,64,17,19,62
10X264,2016,94,62,62,1,2,5,26,59,3,0,1,29,65,69,25,22,72
10X264,2015,100,55,53,0,9,6,28,58,3,3,2,20,80,70,30,28,72
10X264,2014,106,64,59,1,3,7,26,72,1,0,0,14,92,73,33,34,72
10X264,2013,96,71,67,0,4,10,31,50,4,1,0,15,81,52,44,27,69
10X268,2017,119,70,70,36,19,4,4,106,4,1,0,53,66,111,8,6,113
10X268,2016,166,92,90,25,27,4,2,155,4,1,0,73,93,161,5,10,156
10X268,2015,143,85,81,6,22,6,6,127,4,0,0,88,55,135,8,3,140
10X268,2014,118,56,53,17,26,7,4,104,3,0,0,68,50,115,3,4,114
10X268,2013,100,54,50,10,21,8,6,81,3,2,0,52,48,94,6,2,98
10X268,2012,149,63,62,13,28,10,7,131,1,0,0,67,82,140,9,5,144
10X268,2011,73,41,39,11,10,5,5,61,2,0,0,26,47,69,4,4,69
10X268,2010,124,67,67,31,25,9,9,102,4,0,0,58,66,116,8,4,120
10X268,2009,129,52,52,13,25,10,4,112,3,0,0,60,69,119,10,1,128
10X268,2008,114,52,51,17,29,4,10,99,1,0,0,58,56,94,20,1,113
10X268,2007,135,76,66,12,19,9,8,112,6,0,0,70,65,122,13,1,134
10X268,2006,118,67,41,12,13,10,12,94,2,0,0,48,70,104,14,1,117
10X268,2005,127,73,42,14,28,4,11,105,3,1,3,71,56,111,16,0,127
10X284,2017,100,83,83,16,11,1,19,79,1,0,0,53,47,84,16,20,80
10X284,2016,100,79,79,4,11,2,20,55,3,1,0,47,53,88,12,19,81
10X284,2015,81,59,41,0,8,2,25,68,3,0,0,41,40,68,13,17,64
10X284,2014,98,71,58,0,11,1,30,67,3,0,0,42,56,85,13,22,76
10X284,2013,101,74,61,3,12,2,33,58,2,0,0,46,55,91,10,23,78
10X284,2012,95,63,48,2,18,2,30,80,4,0,1,52,43,69,26,18,77
10X284,2011,117,67,64,6,17,1,39,56,2,0,0,54,63,99,18,30,87
10X284,2010,104,55,49,8,12,3,39,53,4,0,0,35,69,83,21,19,85
10X284,2009,92,49,46,1,20,2,50,51,1,0,1,42,50,83,9,9,83
10X284,2008,101,62,57,1,20,2,26,46,3,1,1,49,52,77,24,12,89
10X284,2007,98,60,51,5,20,3,28,48,3,0,1,53,45,82,16,10,88
10X284,2006,99,58,50,5,19,1,0,0,0,0,0,59,40,79,20,13,86
10X284,2005,105,70,57,10,11,0,26,69,4,1,0,58,47,88,17,6,99
10X284,2004,79,60,47,7,5,0,36,64,4,0,0,49,30,67,12,5,74
10X284,2003,83,58,49,6,9,0,35,56,1,0,0,47,36,71,12,7,76
10X319,2017,67,6,6,0,19,1,13,64,0,37,0,24,43,61,6,8,59
10X319,2016,138,22,21,0,29,1,6,92,1,34,0,61,77,129,9,22,116
10X319,2015,115,12,10,0,45,1,22,82,0,21,0,63,52,100,15,22,93
10X319,2014,110,13,12,0,31,1,41,61,1,0,0,60,50,104,6,17,93
10X319,2013,134,11,8,0,38,2,53,64,2,0,0,74,60,108,26,26,108
10X319,2012,102,9,8,0,45,1,23,19,0,0,0,54,48,88,14,22,80
10X319,2011,126,14,12,0,48,0,5,45,1,16,0,75,51,112,14,27,99
10X319,2010,104,8,5,0,31,0,9,94,0,35,0,63,41,91,13,26,78
10X319,2009,121,13,12,0,41,0,11,68,0,31,0,66,55,99,22,12,109
10X319,2008,101,16,12,0,27,0,21,65,0,16,0,53,48,85,16,17,84
10X319,2007,92,18,14,0,21,0,41,58,1,1,0,54,38,78,14,12,80
10X319,2006,113,24,21,0,24,0,46,45,0,1,0,77,36,93,20,10,103
10X319,2005,82,24,3,0,22,0,45,66,2,0,0,46,36,71,11,5,77
10X319,2004,36,18,2,0,4,0,27,53,1,1,0,24,12,30,6,2,34
10X319,2003,51,18,18,0,11,0,13,23,0,0,0,35,16,37,14,5,46
10X319,2002,43,0,0,0,10,0,23,28,0,0,0,16,27,22,21,2,41
10X319,2001,10,0,0,0,0,0,5,5,0,0,0,3,7,3,7,0,10
10X342,2017,93,65,65,56,4,1,0,115,0,0,0,54,39,91,2,9,84
10X342,2016,95,67,67,38,11,0,1,102,0,0,0,52,43,93,2,10,85
10X342,2015,103,59,59,13,13,0,1,113,0,0,0,51,52,99,4,6,97
10X342,2014,114,79,78,15,8,0,0,93,0,0,0,56,58,114,0,3,111
10X342,2013,95,66,64,4,3,0,0,95,0,0,0,40,55,82,13,5,90
10X342,2012,100,67,67,3,4,0,0,94,1,0,0,48,52,93,7,15,85
10X342,2011,104,65,65,7,10,0,0,100,0,0,0,51,53,100,4,3,101
10X342,2010,89,53,52,5,9,0,0,104,0,0,0,52,37,84,5,2,87
10X342,2009,116,66,65,14,15,0,0,89,0,0,0,61,55,107,9,2,114
10X342,2008,120,74,70,6,14,0,0,120,0,0,0,62,58,109,11,4,116
10X342,2007,99,57,46,8,15,0,0,99,0,0,0,55,44,73,26,1,98
10X342,2006,83,49,38,0,10,0,0,83,0,0,0,39,44,69,14,1,82
10X342,2005,90,65,62,27,3,0,0,90,0,0,0,44,46,80,10,0,90
10X351,2017,144,116,116,0,2,2,36,92,10,4,0,72,72,103,41,24,120
10X351,2016,119,86,86,0,14,3,41,69,3,0,3,58,61,98,21,26,93
10X351,2015,120,81,77,0,7,6,31,79,2,1,1,56,64,101,19,29,91
10X351,2014,126,69,69,0,11,1,33,82,7,0,3,58,68,111,15,25,101
10X351,2013,105,24,23,0,12,1,29,71,4,0,0,44,61,90,15,20,85
10X351,2012,6,0,0,0,0,0,5,1,0,0,0,3,3,5,1,2,4
10X353,2017,132,132,115,0,0,1,26,102,0,2,1,67,65,95,37,26,106
10X353,2016,142,134,117,3,6,1,33,100,2,3,3,83,59,109,33,22,120
10X353,2015,109,96,70,0,5,2,24,81,0,0,2,53,56,85,24,27,82
10X353,2014,92,74,60,1,8,1,14,52,1,1,1,50,42,77,15,22,70
10X353,2013,70,60,46,2,5,0,25,66,1,0,0,41,29,65,5,15,55
10X368,2017,150,119,119,13,9,9,10,123,5,3,0,62,88,126,24,38,112
10X368,2016,118,99,93,5,3,4,11,92,5,4,2,53,65,103,15,26,92
10X368,2015,108,98,90,0,6,7,10,83,8,0,0,46,62,92,16,18,90
10X368,2014,103,79,66,6,4,3,13,78,9,0,0,51,52,86,17,17,86
10X368,2013,118,100,87,13,1,2,14,97,4,1,0,64,54,108,10,24,94
10X368,2012,160,130,120,22,8,5,13,136,6,0,0,79,81,140,20,22,138
10X368,2011,135,108,98,15,2,5,12,114,4,0,0,76,59,117,18,21,114
10X368,2010,116,103,96,8,5,8,17,89,1,1,0,60,56,99,17,7,109
10X368,2009,125,85,80,6,14,5,12,104,3,1,0,56,69,106,19,18,107
10X368,2008,124,97,92,7,5,6,16,101,1,0,0,62,62,103,21,13,111
10X368,2007,118,79,64,16,6,6,14,92,5,1,0,68,50,99,19,11,107
10X368,2006,115,72,37,5,14,3,20,84,8,0,0,51,64,94,21,14,101
10X368,2005,125,77,45,11,17,5,23,94,3,0,0,57,68,98,27,14,111
10X368,2004,110,65,28,3,16,3,18,82,7,0,0,52,58,92,18,5,105
10X368,2003,83,56,28,1,8,3,16,60,4,0,0,42,41,72,11,4,79
10X374,2017,110,110,110,47,0,4,26,70,4,1,0,69,41,100,10,25,85
10X374,2016,105,92,92,20,7,4,28,84,4,0,4,58,47,92,13,26,79
10X374,2015,124,109,96,28,9,3,33,72,2,0,4,82,42,105,19,34,90
10X374,2014,114,105,91,14,2,3,33,62,0,0,1,57,57,104,10,23,91
10X374,2013,99,90,78,19,4,4,44,84,5,0,1,56,43,88,11,25,74
10X374,2012,138,125,115,5,6,3,31,52,3,0,1,80,58,116,22,31,107
10X374,2011,90,72,69,7,9,2,29,53,3,0,1,55,35,80,10,12,78
10X374,2010,88,70,68,9,2,2,41,68,1,2,0,54,34,80,8,11,77
10X374,2009,80,60,59,6,4,0,34,73,2,1,0,40,40,67,13,10,70
10X374,2008,84,57,57,8,7,0,31,48,0,1,0,42,42,75,9,7,77
10X374,2007,114,105,100,31,2,0,28,54,2,0,0,67,47,93,21,1,113
10X397,2017,79,37,37,0,22,4,11,62,1,1,0,30,49,74,5,3,76
10X397,2016,133,53,53,0,45,4,31,87,10,1,0,54,79,119,14,0,133
10X397,2015,119,23,19,0,60,1,21,92,3,2,0,54,65,97,22,1,118
10X397,2014,115,30,28,0,44,3,11,97,4,0,0,49,66,88,27,0,115
10X397,2013,104,22,19,0,34,2,18,79,4,1,0,43,61,70,34,1,103
10X397,2012,117,33,32,0,50,11,20,83,1,2,0,45,72,93,24,0,117
10X397,2011,87,18,17,0,35,1,15,71,0,0,0,29,58,70,17,0,87
10X397,2010,74,13,13,0,24,7,18,46,1,2,0,39,35,58,16,1,73
10X397,2009,81,16,16,0,24,13,11,56,1,0,0,35,46,56,25,0,81
10X397,2008,76,22,22,0,20,5,11,58,2,0,0,32,44,56,20,0,76
10X397,2007,9,0,0,0,2,0,1,7,1,0,0,5,4,8,1,0,9
10X410,2003,15,3,0,0,9,5,109,211,2,1,0,65,76,93,48,35,106
10X410,2002,141,28,1,0,97,0,7,8,0,0,0,157,171,258,70,79,249
10X410,2001,328,67,2,0,198,0,0,1,0,0,0,0,1,0,1,1,0
10X430,2004,324,154,28,9,91,5,113,501,7,1,1,157,167,288,36,65,259
10X430,2003,628,197,75,10,205,21,162,581,7,1,0,310,318,540,88,100,528
10X430,2002,772,223,83,6,181,23,177,553,8,0,0,393,379,658,114,87,685
10X430,2001,761,226,66,14,176,0,0,4,0,0,0,389,372,660,101,142,619
10X433,2017,102,75,75,31,12,1,18,75,8,0,0,57,45,88,14,19,83
10X433,2016,119,85,81,18,15,4,17,88,9,0,1,58,61,109,10,39,80
10X433,2015,102,76,57,2,13,4,19,72,5,0,2,52,50,90,12,12,90
10X433,2014,111,81,61,1,11,2,24,80,4,0,1,63,48,95,16,26,85
10X433,2013,112,88,65,1,10,1,24,84,3,0,0,74,38,96,16,27,85
10X433,2012,112,72,58,1,13,1,21,87,2,0,1,61,51,91,21,25,87
10X433,2011,114,61,47,0,16,3,23,84,4,0,0,60,54,99,15,19,95
10X433,2010,118,72,63,2,12,3,33,79,3,0,0,68,50,110,8,27,91
10X433,2009,135,85,78,4,14,7,35,92,1,0,0,73,62,117,18,29,106
10X433,2008,136,68,59,2,29,5,35,78,2,0,0,81,55,124,12,25,111
10X433,2007,120,84,71,6,19,1,41,80,4,0,1,67,53,109,11,21,99
10X433,2006,134,88,56,1,30,1,38,72,0,0,0,83,51,120,14,18,116
10X433,2005,127,66,39,3,23,1,43,73,2,1,2,86,41,105,22,24,103
10X433,2004,111,64,31,6,17,4,47,75,3,0,0,78,33,95,16,11,100
10X433,2003,122,73,28,4,15,2,16,24,2,0,0,91,31,103,19,8,114
10X433,2002,129,69,42,4,11,0,44,90,2,0,0,83,46,115,14,8,121
10X433,2001,44,39,28,2,0,0,44,89,0,1,0,36,8,43,1,1,43
10X434,2017,91,65,65,17,9,3,17,69,1,1,0,49,42,77,14,23,68
10X434,2016,92,78,78,39,5,4,15,71,1,0,1,53,39,77,15,24,68
10X434,2015,87,66,61,21,4,3,24,57,1,0,2,50,37,75,12,18,69
10X434,2014,107,85,82,19,4,1,28,76,2,0,0,53,54,86,21,15,92
10X434,2013,98,86,84,33,2,3,34,60,1,0,0,55,43,83,15,16,82
10X434,2012,93,75,74,10,4,2,27,62,2,0,0,54,39,81,12,6,87
10X434,2011,94,52,49,14,9,3,24,63,3,1,0,51,43,82,12,16,78
10X434,2010,86,54,50,7,9,1,26,57,2,0,0,44,42,75,11,13,73
10X434,2009,94,53,53,16,13,4,28,61,1,0,0,54,40,90,4,12,82
10X434,2008,99,56,53,14,17,5,28,64,1,1,0,47,52,86,13,14,85
10X434,2007,74,50,44,0,10,1,23,49,1,0,0,44,30,63,11,8,66
10X434,2006,96,61,59,3,11,2,39,54,1,0,0,44,52,86,10,16,80
10X434,2005,96,53,47,8,10,2,31,53,1,1,0,58,38,86,10,24,72
10X434,2004,88,51,27,8,14,1,30,53,2,0,0,41,47,80,8,21,67
10X434,2003,86,37,17,3,18,4,27,53,1,0,1,46,40,67,19,19,67
10X434,2002,86,47,23,0,9,0,33,62,1,0,0,51,35,73,13,7,79
10X435,2002,195,6,0,0,135,0,2,3,0,0,0,79,116,150,45,121,335
10X435,2001,456,90,0,0,195,0,0,1,0,0,0,211,245,348,108,1,0
10X437,2017,83,80,80,64,3,1,30,50,1,1,0,61,22,64,19,20,63
10X437,2016,67,64,64,20,1,1,25,38,3,0,0,50,17,59,8,13,54
10X437,2015,62,59,56,14,1,3,38,57,3,0,0,47,15,60,2,9,53
10X437,2014,87,82,76,29,2,1,28,44,2,0,0,64,23,78,9,11,76
10X437,2013,101,93,85,21,3,2,32,58,1,0,0,74,27,87,14,19,82
10X437,2012,75,73,66,7,1,3,23,54,0,0,0,41,34,66,9,18,57
10X437,2011,89,77,71,2,2,1,35,53,1,0,0,51,38,81,8,15,74
10X437,2010,93,67,64,15,7,1,31,34,3,0,0,60,33,78,15,24,69
10X437,2009,80,63,60,11,5,2,44,34,2,0,0,40,40,74,6,13,67
10X437,2008,90,61,59,10,3,2,28,56,3,0,0,50,40,79,11,22,68
10X437,2007,69,57,45,11,2,1,32,47,3,0,0,51,18,62,7,10,59
10X437,2006,82,60,41,8,6,1,32,45,2,0,0,50,32,74,8,15,67
10X437,2005,89,63,33,1,10,0,31,30,1,0,0,49,40,77,12,25,64
10X437,2004,83,47,34,0,17,0,24,60,2,0,1,37,46,70,13,23,60
10X437,2003,115,45,21,0,33,0,28,58,3,0,0,48,67,88,27,27,88
10X437,2002,80,8,8,0,13,0,47,68,0,0,0,36,44,57,23,5,75
10X438,2017,65,65,65,12,0,1,14,49,1,0,0,40,25,57,8,14,51
10X438,2016,69,66,66,36,3,3,17,47,2,0,0,29,40,61,8,17,52
10X438,2015,64,57,48,5,4,2,16,46,0,0,0,23,41,49,15,15,49
10X438,2014,62,53,42,3,7,1,20,39,1,1,0,24,38,51,11,10,52
10X438,2013,66,43,24,0,12,4,28,76,3,0,0,28,38,55,11,22,44
10X438,2012,111,66,51,0,17,3,33,80,0,0,0,42,69,101,10,30,81
10X438,2011,116,48,37,0,24,5,39,61,2,1,0,51,65,98,18,31,85
10X438,2010,109,35,26,0,24,4,36,74,2,0,0,35,74,94,15,29,80
10X438,2009,108,36,33,0,21,2,44,79,3,1,0,30,78,95,13,23,85
10X438,2008,116,45,44,0,19,3,60,76,2,0,3,48,68,101,15,19,97
10X438,2007,129,59,43,2,29,2,46,73,2,0,0,50,79,104,25,26,103
10X438,2006,144,74,70,4,23,5,42,75,1,0,1,56,88,117,27,27,117
10X438,2005,123,59,45,2,27,3,59,109,2,0,0,50,73,94,29,27,96
10X438,2004,124,49,33,2,29,0,19,42,4,1,0,52,72,104,20,17,107
10X438,2003,173,80,37,1,47,0,27,80,2,0,0,75,98,135,38,16,157
10X438,2002,111,53,21,0,20,0,31,78,1,1,0,48,63,91,20,13,98
10X438,2001,9,0,0,0,1,0,1,8,0,0,0,4,5,5,4,0,9
10X439,2017,84,80,80,11,1,1,26,57,0,0,0,51,33,67,17,16,68
10X439,2016,91,88,88,5,3,2,22,61,4,1,1,56,35,80,11,19,72
10X439,2015,83,77,69,3,3,1,26,52,3,1,0,47,36,76,7,22,61
10X439,2014,84,74,66,3,2,2,18,61,1,0,2,41,43,79,5,20,64
10X439,2013,102,86,75,9,6,1,28,69,3,0,1,53,49,88,14,33,69
10X439,2012,94,73,54,3,7,2,21,67,3,1,0,55,39,81,13,19,75
10X439,2011,89,63,53,3,13,2,24,62,0,0,1,44,45,77,12,23,66
10X439,2010,100,75,64,5,8,4,28,65,1,1,1,57,43,87,13,20,80
10X439,2009,83,57,52,4,9,1,29,53,0,0,0,48,35,72,11,17,66
10X439,2008,115,57,52,0,23,2,39,70,2,0,2,66,49,83,32,23,92
10X439,2007,95,43,32,2,20,1,39,55,0,0,0,54,41,74,21,17,78
10X439,2006,115,46,36,4,14,2,46,65,1,1,0,69,46,104,11,21,94
10X439,2005,97,49,41,3,18,3,36,58,0,0,0,55,42,85,12,14,83
10X439,2004,76,26,16,1,24,0,30,45,1,0,0,50,26,68,8,20,56
10X439,2003,144,60,34,0,46,0,71,72,1,0,0,73,71,115,29,24,120
10X439,2002,75,31,15,0,11,0,32,39,2,2,0,40,35,57,18,4,71
10X440,2017,206,187,187,89,11,24,65,103,9,3,2,80,126,180,26,42,164
10X440,2016,302,258,256,72,28,30,104,155,8,1,4,140,162,259,43,54,248
10X440,2015,307,230,162,22,38,27,95,171,7,3,4,129,178,258,49,45,262
10X440,2014,266,165,134,8,56,34,83,124,18,5,2,129,137,224,42,40,226
10X440,2013,357,163,145,26,93,25,104,209,9,4,6,155,202,280,77,48,309
10X440,2012,653,279,239,35,159,59,191,373,22,4,4,289,364,512,141,132,521
10X440,2011,789,327,297,58,212,53,265,447,16,6,2,330,459,582,207,147,642
10X440,2010,957,397,354,73,238,65,294,572,22,4,0,459,498,735,222,170,787
10X440,2009,1064,512,447,109,204,76,342,617,19,10,0,544,520,869,195,152,912
10X440,2008,1091,454,413,107,169,70,277,707,25,12,0,552,539,819,272,143,948
10X440,2007,1042,525,417,108,177,62,275,676,23,6,0,540,502,775,267,151,891
10X440,2006,1013,572,397,117,177,55,271,653,24,8,2,526,487,815,198,125,888
10X440,2005,1008,608,446,176,138,72,264,638,31,3,0,542,466,781,227,112,896
10X440,2004,937,483,365,134,118,55,220,635,25,2,0,532,405,710,227,99,838
10X440,2003,1072,580,418,171,172,60,274,703,28,7,0,586,486,779,293,120,952
10X440,2002,916,531,372,155,129,56,247,563,47,3,0,523,393,790,126,86,830
10X440,2001,972,558,392,130,116,53,325,556,37,1,0,526,446,903,69,145,827
10X442,2017,90,84,84,56,0,2,23,61,1,0,8,60,30,75,15,19,71
10X442,2016,95,94,94,46,0,4,26,62,1,0,3,64,31,83,12,20,75
10X442,2015,96,84,75,22,1,2,18,70,1,1,3,61,35,77,19,22,74
10X442,2014,95,88,81,18,3,1,18,61,1,0,3,60,35,83,12,11,84
10X442,2013,84,79,78,14,2,2,21,67,2,0,0,54,30,76,8,8,76
10X442,2012,92,80,79,8,0,1,25,74,2,0,0,64,28,72,20,9,83
10X442,2011,89,81,80,8,5,1,20,68,1,0,0,50,39,72,17,9,80
10X442,2010,102,86,83,9,5,1,27,46,0,0,0,59,43,91,11,8,94
10X442,2009,76,62,58,7,1,1,22,51,2,0,0,42,34,63,13,4,72
10X442,2008,90,66,60,7,5,0,13,72,1,2,2,60,30,74,16,9,81
10X442,2007,85,60,43,2,6,0,30,56,2,1,0,52,33,60,25,7,78
10X442,2006,82,61,44,11,6,0,20,54,2,0,0,42,40,63,19,5,77
10X442,2005,74,50,38,6,2,0,32,52,1,0,0,46,28,61,13,11,63
10X442,2004,72,42,25,3,3,0,21,58,3,0,0,40,32,59,13,0,72
10X442,2003,76,60,37,6,3,0,24,46,2,0,0,42,34,55,21,5,71
10X445,2017,740,739,739,720,0,501,20,52,151,3,13,295,445,351,389,17,723
10X445,2016,751,751,751,726,0,476,22,52,185,2,14,309,442,348,403,8,743
10X445,2015,741,737,737,695,0,493,17,50,158,8,15,303,438,352,389,6,735
10X445,2014,719,714,714,693,2,475,14,32,186,0,12,309,410,332,387,5,714
10X445,2013,727,725,725,695,0,454,16,45,205,2,5,332,395,316,411,13,714
10X445,2012,783,780,780,713,1,493,24,43,154,0,69,333,450,359,424,8,775
10X445,2011,737,730,730,728,1,497,26,50,158,2,4,318,419,358,379,14,723
10X445,2010,749,746,746,743,2,464,26,61,191,2,5,300,449,361,388,5,744
10X445,2009,753,750,750,748,0,471,23,59,199,1,0,316,437,354,399,7,746
10X445,2008,727,725,725,722,0,459,28,42,195,3,0,317,410,320,407,6,721
10X445,2007,728,724,724,716,0,449,24,71,183,1,0,317,411,326,402,3,725
10X445,2006,668,657,657,653,0,418,22,52,174,2,0,285,383,247,421,4,664
10X445,2005,581,574,574,568,0,340,33,36,170,2,0,274,307,197,384,1,580
10X445,2004,594,584,584,579,2,340,25,38,189,2,0,284,310,160,434,2,592
10X445,2003,559,549,549,544,0,290,27,52,172,1,17,266,293,231,328,1,558
10X445,2002,587,573,573,572,0,291,38,35,220,3,0,247,340,209,378,1,586
10X445,2001,641,614,614,605,2,284,48,63,244,2,0,300,341,216,425,2,639
10X475,2010,133,53,48,0,61,1,38,93,1,0,0,39,94,112,21,39,94
10X475,2009,273,81,74,2,83,2,85,178,7,1,0,89,184,241,32,54,219
10X475,2008,325,131,116,6,103,2,124,196,3,0,0,105,220,278,47,72,253
10X475,2007,379,133,91,4,108,4,119,249,4,3,0,140,239,304,75,87,292
10X475,2006,502,179,97,14,147,7,134,348,10,2,1,188,314,389,113,85,417
10X475,2005,716,280,121,1,131,20,193,483,18,1,1,278,438,514,202,129,587
10X475,2004,771,350,104,13,125,14,219,520,15,2,1,320,451,468,303,110,661
10X475,2003,700,245,109,21,206,11,211,452,22,3,1,307,393,498,202,95,605
10X475,2002,857,282,157,33,250,22,218,585,28,3,1,357,500,611,246,85,772
10X475,2001,930,291,157,36,245,29,227,631,40,3,0,397,533,644,286,113,817
10X477,2017,106,103,103,65,0,23,10,64,4,5,0,60,46,91,15,16,90
10X477,2016,113,107,107,70,2,8,19,75,10,1,0,65,48,99,14,16,97
10X477,2015,112,105,105,47,2,19,22,63,7,1,0,57,55,99,13,9,103
10X477,2014,98,84,83,26,1,11,19,64,2,1,1,49,49,91,7,11,87
10X477,2013,104,93,93,22,1,7,31,60,6,0,0,46,58,98,6,12,92
10X477,2012,113,101,100,39,3,12,23,71,7,0,0,69,44,103,10,7,106
10X477,2011,112,103,102,22,2,12,30,61,8,0,1,58,54,100,12,8,104
10X477,2010,101,91,89,9,1,14,29,49,9,0,0,55,46,95,6,11,90
10X477,2009,116,104,103,22,2,14,23,73,4,2,0,59,57,110,6,8,108
10X477,2008,117,103,101,30,3,12,25,66,13,1,0,67,50,97,20,9,108
10X477,2007,94,75,73,19,2,11,20,58,5,0,0,50,44,81,13,5,89
10X477,2006,107,95,92,23,0,15,16,67,8,1,0,62,45,97,10,10,97
10X477,2005,95,83,78,15,1,15,15,59,6,0,0,52,43,91,4,2,93
10X477,2004,108,94,79,20,4,21,24,55,8,0,0,54,54,104,4,3,105
10X477,2003,92,85,76,12,1,17,22,46,7,0,0,45,47,84,8,0,92
10X477,2002,80,71,62,6,4,10,11,48,11,0,0,38,42,73,7,0,80
10X524,2017,91,77,77,0,3,6,4,81,0,0,0,50,41,82,9,7,84
10X524,2016,81,68,68,0,6,3,5,72,1,0,0,41,40,69,12,4,77
10X524,2015,85,61,54,0,12,2,6,73,4,0,0,41,44,70,15,10,75
10X524,2014,91,54,43,0,28,1,8,79,1,2,0,41,50,70,21,4,87
10X524,2013,105,62,56,0,20,3,11,87,3,0,1,51,54,62,43,7,98
10X524,2012,80,28,26,0,29,3,15,78,4,0,0,34,46,59,21,4,76
10X524,2011,100,39,39,0,24,0,7,73,0,0,0,55,45,94,6,1,99
10X546,2017,76,67,67,19,8,1,30,61,4,1,0,54,22,67,9,22,54
10X546,2016,97,83,82,3,8,1,18,45,1,1,1,68,29,84,13,17,80
10X546,2015,79,63,51,4,7,1,28,55,3,0,0,52,27,74,5,18,61
10X546,2014,67,54,46,5,10,1,28,60,2,0,0,48,19,52,15,20,47
10X546,2013,81,49,48,0,12,1,28,61,2,1,0,58,23,65,16,18,63
10X546,2012,87,61,57,1,9,1,34,66,4,0,0,62,25,67,20,12,75
10X546,2011,102,63,50,0,8,1,34,70,3,0,0,70,32,85,17,30,72
10X546,2010,91,60,57,2,10,2,25,43,3,0,0,58,33,73,18,10,81
10X546,2009,102,76,71,2,9,0,24,49,3,0,0,69,33,83,19,12,90
10X546,2008,93,67,62,3,11,0,27,48,2,1,1,68,25,78,15,12,81
10X546,2007,105,56,50,1,21,0,25,56,0,0,0,71,34,78,27,16,89
10X546,2006,108,56,34,3,20,0,32,67,3,0,0,72,36,91,17,17,91
10X546,2005,100,66,39,1,13,0,21,79,2,0,0,75,25,85,15,7,93
10X546,2004,100,58,30,3,16,0,35,63,2,0,0,66,34,83,17,11,89
10X546,2003,73,55,36,2,6,0,35,62,3,0,0,44,29,58,15,8,65
10X549,2017,110,99,99,44,8,3,23,83,1,0,0,51,59,99,11,29,81
10X549,2016,111,101,101,1,5,6,21,81,2,1,0,52,59,99,12,30,81
10X549,2015,116,94,85,6,10,3,22,85,4,1,1,57,59,102,14,28,88
10X549,2014,102,84,83,30,11,4,20,74,4,0,0,47,55,87,15,31,71
10X549,2013,107,79,76,38,8,1,26,77,2,1,0,45,62,88,19,29,78
10X549,2012,121,89,85,43,14,3,20,92,4,1,1,52,69,96,25,30,91
10X549,2011,147,84,83,42,18,5,23,116,3,0,0,66,81,116,31,34,113
10X549,2010,129,72,60,43,22,5,20,101,0,2,1,63,66,111,18,32,97
10X549,2009,137,63,60,39,20,2,26,104,4,0,1,62,75,119,18,24,113
10X549,2008,107,54,53,31,16,2,37,65,0,3,0,55,52,83,24,18,89
10X549,2007,120,73,66,18,21,4,32,82,2,0,0,51,69,94,26,20,100
10X549,2006,96,62,56,24,13,1,24,40,2,0,0,46,50,83,13,15,81
10X549,2005,101,55,43,21,12,0,19,77,0,0,0,54,47,92,9,25,76
10X549,2004,91,56,27,4,8,0,29,70,2,0,0,38,53,58,33,25,66
10X549,2003,67,34,22,1,7,0,39,51,1,0,0,44,23,43,24,13,54
10X565,2017,81,71,71,16,2,1,24,54,2,0,0,23,58,64,17,23,58
10X565,2016,80,64,64,1,9,2,24,51,1,1,1,17,63,69,11,23,57
10X565,2015,104,74,67,5,9,6,25,72,0,0,1,19,85,88,16,24,80
10X565,2014,100,71,68,4,6,1,27,67,0,1,4,16,84,77,23,25,75
10X565,2013,91,56,55,9,12,2,16,70,2,1,0,18,73,64,27,20,71
10X565,2012,93,76,73,0,13,1,27,61,2,2,0,15,78,64,29,20,73
10X660,2011,104,53,45,0,41,3,20,80,1,0,0,59,45,80,24,32,72
10X660,2010,264,73,64,0,78,5,78,178,1,2,0,150,114,209,55,76,188
10X660,2009,312,78,73,2,78,2,97,208,5,0,0,203,109,312,0,79,233
10X660,2008,334,107,101,4,107,6,110,209,5,4,0,215,119,334,0,60,274
10X660,2007,352,106,81,0,93,5,104,235,6,2,0,215,137,340,12,66,286
10X660,2006,362,152,103,7,98,5,129,221,4,2,1,232,130,356,6,74,288
10X660,2005,367,152,81,11,83,2,107,246,11,1,0,238,129,361,6,77,290
10X660,2004,256,93,54,10,74,2,87,163,1,1,2,141,115,251,5,51,205
10X660,2003,319,137,59,17,82,6,115,191,3,2,2,195,124,296,23,55,264
10X660,2002,367,149,51,3,87,7,129,218,12,1,0,246,121,206,161,52,315
10X660,2001,288,109,33,4,72,3,114,162,8,1,0,203,85,210,78,67,221
10X696,2017,93,92,92,92,0,20,4,12,55,1,1,47,46,23,70,1,92
10X696,2016,106,106,106,106,0,24,4,11,63,0,4,51,55,23,83,2,104
10X696,2015,100,99,99,98,0,20,3,8,61,1,7,49,51,27,73,2,98
10X696,2014,91,90,90,89,0,21,3,15,48,1,3,48,43,19,72,1,90
10X696,2013,75,74,74,72,0,17,4,14,38,0,2,35,40,22,53,3,72
10X696,2012,96,96,96,93,0,24,3,17,51,0,1,45,51,22,74,2,94
10X696,2011,97,96,96,89,0,22,5,11,59,0,0,42,55,32,65,0,97
10X696,2010,99,98,98,92,0,21,14,16,46,2,0,45,54,32,67,2,97
10X696,2009,94,94,94,81,0,15,10,18,50,1,0,52,42,28,66,1,93
10X696,2008,89,87,87,76,0,12,10,22,45,0,0,34,55,30,59,3,86
10X696,2007,84,82,82,79,0,11,12,23,36,2,0,38,46,26,58,0,84
10X696,2006,78,76,76,68,1,10,19,19,30,0,0,38,40,28,50,2,76
10X696,2005,75,72,72,61,0,14,20,17,24,0,0,37,38,26,49,0,75
10X696,2004,87,82,82,79,0,19,14,18,36,0,0,45,42,31,56,1,86
10X696,2003,87,82,82,71,0,17,21,28,21,0,0,48,39,31,56,0,87
10X696,2002,59,55,55,33,1,15,18,9,17,0,0,31,28,13,46,0,59
11X249,2017,60,58,58,50,0,5,36,15,2,2,0,32,28,44,16,4,56
11X249,2016,54,54,54,22,0,4,34,14,2,0,0,32,22,41,13,3,51
11X249,2015,47,47,46,9,0,4,22,17,4,0,0,27,20,36,11,0,47
11X249,2014,70,65,65,18,1,10,39,16,3,1,1,41,29,42,28,2,68
11X249,2013,55,52,51,10,0,5,26,18,0,2,4,32,23,41,14,3,52
11X249,2012,61,55,55,15,0,3,37,15,4,2,0,32,29,46,15,2,59
11X249,2011,85,82,80,16,1,2,52,28,1,1,1,57,28,66,19,6,79
11X249,2010,64,61,59,2,0,4,41,17,0,2,0,36,28,54,10,6,58
11X249,2009,57,56,56,4,0,2,33,21,1,0,0,36,21,45,12,1,56
11X249,2008,70,67,66,7,0,9,40,20,0,1,0,48,22,60,10,2,68
11X249,2007,58,55,53,24,1,1,24,33,0,0,0,40,18,49,9,3,55
11X249,2006,58,56,56,11,0,4,25,27,0,2,0,38,20,46,12,1,57
11X249,2005,61,58,54,6,3,2,35,24,0,0,0,46,15,47,14,0,61
11X249,2004,71,57,51,5,10,2,25,40,2,0,2,54,17,63,8,3,68
11X253,2017,89,65,65,0,13,8,34,36,1,1,1,48,41,70,19,19,70
11X253,2016,81,53,48,0,14,2,48,42,2,0,0,39,42,64,17,15,66
11X253,2015,94,66,54,0,9,4,39,38,2,2,2,47,47,69,25,24,70
11X253,2014,87,52,47,0,16,2,45,47,2,2,1,44,43,65,22,13,74
11X253,2013,99,64,49,2,11,2,49,52,2,1,0,39,60,62,37,31,68
11X253,2012,106,72,60,0,13,4,49,57,1,1,0,58,48,63,43,32,74
11X253,2011,112,58,52,0,22,3,42,43,2,0,0,60,52,74,38,22,90
11X253,2010,90,57,50,0,17,3,67,34,3,2,0,51,39,63,27,18,72
11X253,2009,109,53,48,2,20,2,47,44,1,0,0,68,41,109,0,17,92
11X253,2008,94,48,42,2,16,2,57,54,2,1,0,55,39,94,0,17,77
11X253,2007,116,65,56,2,16,1,69,45,1,2,0,66,50,113,3,18,98
11X253,2006,118,79,67,3,14,2,50,42,2,0,0,74,44,115,3,17,101
11X253,2005,96,60,30,1,18,1,50,38,3,1,0,56,40,71,25,11,85
11X253,2004,93,63,24,0,13,0,38,44,6,1,0,63,30,77,16,4,89
11X253,2003,6,0,0,0,2,0,6,0,0,0,0,3,3,4,2,2,4
11X265,2017,88,62,62,0,9,2,25,55,4,2,0,28,60,73,15,21,67
11X265,2016,82,61,61,0,11,4,43,51,2,0,1,30,52,70,12,18,64
11X265,2015,101,63,60,0,10,1,47,48,1,1,1,40,61,84,17,31,70
11X265,2014,99,42,42,0,16,6,33,51,2,1,0,46,53,76,23,19,80
11X265,2013,93,51,49,0,15,2,44,53,4,1,1,38,55,57,36,22,71
11X265,2012,105,62,60,0,9,5,42,74,2,0,0,53,52,63,42,17,88
11X265,2011,123,92,86,0,9,3,41,61,1,1,1,50,73,70,53,17,106
11X265,2010,108,65,58,0,6,5,46,60,2,1,0,39,69,75,33,19,89
11X265,2009,114,69,68,0,15,1,37,69,2,0,0,45,69,114,0,18,96
11X265,2008,109,51,50,0,15,3,39,46,1,1,0,50,59,109,0,14,95
11X265,2007,90,54,42,1,7,2,45,46,1,0,0,43,47,90,0,13,77
11X265,2006,94,59,31,1,7,1,41,54,2,0,0,39,55,92,2,12,82
11X265,2005,96,71,37,0,0,0,28,47,3,3,1,50,46,79,17,11,85
11X265,2004,98,84,49,0,2,0,50,45,1,0,0,58,40,78,20,6,92
11X270,2017,88,69,69,21,14,4,72,25,2,2,0,47,41,76,12,18,70
11X270,2016,85,69,68,11,6,4,63,30,1,1,1,49,36,65,20,14,71
11X270,2015,105,72,53,0,18,7,60,23,4,2,0,48,57,74,31,26,79
11X270,2014,100,75,60,4,13,1,65,34,1,0,0,61,39,77,23,18,82
11X270,2013,96,57,50,1,12,1,45,22,1,1,0,41,55,68,28,22,74
11X270,2012,92,57,52,3,13,4,56,24,1,1,0,41,51,68,24,13,79
11X270,2011,101,59,52,2,10,2,45,25,0,1,0,52,49,72,29,25,76
11X270,2010,70,45,42,0,13,1,52,31,0,1,0,29,41,51,19,9,61
11X270,2009,86,58,50,3,4,1,36,27,1,0,0,35,51,61,25,21,65
11X270,2008,73,45,44,5,11,1,39,31,0,0,0,36,37,46,27,11,62
11X270,2007,85,42,32,1,17,0,55,28,4,0,1,40,45,53,32,19,66
11X270,2006,65,43,30,2,2,0,59,22,4,0,0,29,36,42,23,4,61
11X270,2005,71,42,22,3,7,0,63,26,2,1,0,30,41,58,13,5,66
11X275,2017,116,92,92,35,10,12,44,59,1,0,0,19,97,82,34,20,96
11X275,2016,121,98,98,48,7,11,43,61,3,3,0,19,102,95,26,27,94
11X275,2015,108,84,82,11,6,9,37,58,2,2,0,25,83,81,27,23,85
11X275,2014,138,88,88,15,9,6,56,74,2,0,0,18,120,100,38,34,104
11X275,2013,114,65,65,19,5,5,45,57,3,2,2,18,96,66,48,28,86
11X275,2012,115,87,85,13,4,10,31,71,1,2,0,17,98,66,49,25,90
11X275,2011,126,93,92,19,1,6,46,72,0,1,1,15,111,83,43,22,104
11X275,2010,113,94,90,7,2,6,42,63,2,0,0,16,97,67,46,28,85
11X275,2009,126,103,98,19,5,4,44,76,1,1,0,16,110,126,0,22,104
11X275,2008,116,90,84,12,4,2,41,70,2,1,0,23,93,116,0,23,93
11X275,2007,129,97,87,19,20,5,52,70,1,1,0,16,113,127,2,15,114
11X275,2006,90,74,60,11,3,6,32,48,3,1,0,19,71,87,3,13,77
11X275,2005,95,75,53,1,1,2,38,54,0,1,0,19,76,73,22,2,93
11X275,2004,85,74,45,45,2,3,34,42,5,1,0,27,58,76,9,10,75
11X288,2017,153,128,128,89,11,22,52,56,21,2,0,70,83,120,33,30,123
11X288,2016,151,136,136,73,7,17,50,61,20,2,1,69,82,111,40,19,132
11X288,2015,156,137,130,61,9,15,55,70,13,2,1,68,88,107,49,33,123
11X288,2014,171,143,138,63,13,27,57,63,17,1,6,76,95,114,57,23,148
11X288,2013,158,139,135,44,10,16,48,75,17,2,0,78,80,104,54,23,135
11X288,2012,193,160,153,49,12,24,67,81,19,1,1,87,106,141,52,34,159
11X288,2011,163,134,129,57,12,18,56,74,15,0,0,71,92,111,52,27,136
11X288,2010,123,101,97,31,11,11,43,59,9,1,0,48,75,92,31,17,106
11X288,2009,146,125,120,44,6,12,60,63,11,0,0,63,83,117,29,22,124
11X288,2008,105,92,92,42,0,11,38,53,3,0,0,48,57,82,23,8,97
11X288,2007,103,83,79,28,14,3,47,45,7,1,0,39,64,65,38,14,89
11X288,2006,121,90,81,36,19,7,46,56,11,1,0,56,65,78,43,18,103
11X288,2005,113,81,63,22,13,5,47,52,7,0,2,49,64,84,29,16,97
11X288,2004,91,75,63,19,1,10,42,34,4,0,1,49,42,68,23,0,91
11X288,2003,94,88,79,29,1,12,31,44,7,0,0,38,56,70,24,2,92
11X290,2017,83,77,77,31,4,2,43,34,3,1,0,61,22,66,17,15,68
11X290,2016,77,65,65,14,6,2,38,37,0,0,0,49,28,63,14,10,67
11X290,2015,84,70,50,9,5,6,29,47,0,1,1,54,30,64,20,20,64
11X290,2014,95,66,54,3,17,5,31,51,6,0,2,62,33,71,24,28,67
11X290,2013,104,78,68,13,8,7,45,48,2,2,0,66,38,68,36,20,84
11X290,2012,115,85,75,9,12,4,61,50,0,0,0,81,34,68,47,27,88
11X290,2011,133,88,85,7,10,7,66,59,1,0,0,86,47,89,44,29,104
11X290,2010,95,60,56,6,13,1,54,38,1,1,0,64,31,64,31,21,74
11X290,2009,118,65,60,5,13,6,66,42,2,2,0,83,35,118,0,21,97
11X290,2008,113,76,70,5,13,4,64,43,1,1,0,76,37,113,0,21,92
11X290,2007,115,80,69,6,15,2,61,50,2,0,0,88,27,111,4,21,94
11X290,2006,99,62,53,6,18,4,54,37,3,0,1,64,35,96,3,19,80
11X290,2005,105,66,51,6,15,5,56,42,0,1,1,78,27,77,28,10,95
11X290,2004,80,47,42,5,12,2,44,34,0,0,0,63,17,69,11,7,73
11X290,2003,82,61,45,3,2,3,54,22,1,1,1,48,34,65,17,6,76
11X299,2017,113,88,88,16,12,11,30,52,16,1,3,46,67,98,15,20,93
11X299,2016,108,89,88,21,3,10,33,51,12,0,2,53,55,90,18,17,91
11X299,2015,109,78,73,0,4,8,33,52,12,3,1,47,62,83,26,31,78
11X299,2014,104,70,63,10,5,5,39,48,8,1,3,48,56,75,29,24,80
11X299,2013,126,95,88,13,7,5,44,58,15,2,2,52,74,104,22,26,100
11X299,2012,99,70,67,5,8,9,38,45,7,0,0,48,51,81,18,24,75
11X299,2011,124,83,75,9,8,12,32,62,17,1,0,50,74,107,17,30,94
11X299,2010,98,64,57,5,11,11,39,40,8,0,0,44,54,76,22,24,74
11X299,2009,123,71,66,6,10,4,61,43,14,1,0,44,79,97,26,25,98
11X299,2008,109,68,64,0,7,5,44,43,16,1,0,49,60,84,25,18,91
11X299,2007,117,68,47,0,6,6,51,48,10,2,0,58,59,87,30,21,96
11X299,2006,111,72,45,1,10,6,47,49,9,0,0,41,70,79,32,25,86
11X299,2005,95,70,34,4,4,1,51,35,7,0,1,39,56,65,30,7,88
11X299,2004,95,79,31,5,0,2,40,44,7,1,1,47,48,65,30,11,84
11X299,2003,75,68,57,11,3,5,29,36,5,0,0,46,29,63,12,0,75
11X415,2010,92,46,39,4,27,6,28,43,15,0,0,32,60,63,29,32,60
11X415,2009,238,75,70,6,45,16,83,111,27,1,0,116,122,174,64,54,184
11X415,2008,318,105,89,1,56,19,118,150,30,1,0,147,171,216,102,81,237
11X415,2007,397,158,113,1,75,26,161,170,37,1,2,173,224,239,158,85,312
11X415,2006,382,159,93,9,52,23,127,193,36,1,2,167,215,243,139,78,304
11X415,2005,435,156,80,10,77,23,139,217,50,1,5,171,264,276,159,110,325
11X415,2004,422,146,67,0,90,17,145,205,50,0,5,183,239,252,170,91,331
11X415,2003,582,224,99,9,125,28,169,324,49,4,8,240,342,362,220,112,470
11X415,2002,669,308,159,1,69,55,217,318,75,4,0,303,366,515,154,65,604
11X415,2001,819,341,130,29,114,56,300,371,86,6,0,392,427,642,177,118,701
11X418,2017,123,94,94,7,14,4,34,73,9,1,2,57,66,103,20,40,83
11X418,2016,98,73,69,3,11,3,37,49,9,0,0,40,58,73,25,28,70
11X418,2015,116,79,63,4,19,5,28,67,14,2,0,64,52,96,20,38,78
11X418,2014,101,66,51,0,17,4,19,67,10,0,1,52,49,85,16,36,65
11X418,2013,112,69,62,2,13,2,45,58,7,0,0,48,64,82,30,28,84
11X418,2012,122,64,64,6,15,6,31,72,11,0,2,57,65,78,44,25,97
11X418,2011,119,59,52,2,22,3,20,88,7,1,0,61,58,80,39,29,90
11X418,2010,122,58,55,4,9,1,36,75,10,0,0,55,67,90,32,32,90
11X418,2009,117,57,54,6,8,2,45,65,4,1,0,46,71,85,32,21,96
11X418,2008,110,55,55,3,11,2,31,69,8,0,0,45,65,76,34,24,86
11X418,2007,59,31,29,3,3,2,18,37,2,0,0,25,34,59,0,9,50
11X418,2006,95,59,46,7,15,1,39,46,9,0,0,41,54,93,2,26,69
11X418,2005,96,47,26,1,13,1,42,46,7,0,0,46,50,92,4,16,80
11X418,2004,96,59,25,1,6,3,46,45,2,0,0,33,63,67,29,22,74
11X418,2003,72,47,22,0,7,2,22,32,1,0,0,30,42,42,30,11,61
11X418,2002,57,46,17,0,2,0,31,36,4,0,1,22,35,40,17,3,54
11X425,2005,10,4,2,0,2,11,236,220,5,1,0,71,91,143,19,2,8
11X425,2004,162,58,15,0,67,19,261,208,8,2,0,207,266,364,109,38,124
11X425,2003,473,138,48,4,170,22,334,207,13,0,0,188,310,398,100,91,382
11X425,2002,498,134,51,0,176,0,1,0,0,0,0,258,318,486,90,85,413
11X425,2001,576,196,50,5,204,0,6,2,0,0,2,0,1,0,1,117,459
11X455,2017,523,403,401,97,52,16,276,197,19,13,2,216,307,379,144,123,400
11X455,2016,539,408,402,71,66,14,287,208,20,7,3,244,295,399,140,110,429
11X455,2015,513,365,341,38,83,16,270,209,11,6,1,217,296,349,164,134,379
11X455,2014,525,396,373,51,61,16,276,208,21,4,0,218,307,346,179,116,409
11X455,2013,509,377,356,46,74,8,271,214,9,7,0,208,301,307,202,105,404
11X455,2012,497,333,321,33,73,18,261,199,8,10,1,198,299,286,211,85,412
11X455,2011,415,256,248,20,74,7,228,172,5,3,0,179,236,256,159,61,354
11X455,2010,400,257,251,20,73,6,210,176,5,3,0,148,252,244,156,57,343
11X455,2009,433,247,230,22,90,10,219,191,9,4,0,182,251,234,199,74,359
11X455,2008,467,292,275,23,101,7,250,199,3,8,0,182,285,217,250,94,373
11X455,2007,618,356,326,11,110,12,339,255,4,8,0,256,362,293,325,137,481
11X455,2006,565,338,293,21,78,18,333,206,5,3,0,267,298,234,331,120,445
11X455,2005,628,372,292,22,67,10,382,223,8,5,0,287,341,201,427,138,490
11X455,2004,670,353,281,1,104,12,392,260,5,1,0,316,354,220,450,128,542
11X455,2003,541,318,222,20,99,11,371,146,7,6,0,247,294,197,344,78,463
11X455,2002,535,298,216,16,64,7,355,161,9,3,0,270,265,154,381,64,471
11X455,2001,525,293,207,43,65,4,362,141,15,3,0,239,286,116,409,83,442
11X508,2017,124,100,100,15,1,7,36,70,10,0,1,64,60,110,14,33,91
11X508,2016,116,96,96,20,4,5,31,68,10,2,0,54,62,101,15,31,85
11X508,2015,111,86,68,3,9,4,34,62,9,1,1,53,58,91,20,24,87
11X508,2014,100,82,61,3,8,3,31,58,7,1,0,49,51,83,17,22,78
11X508,2013,91,70,53,4,7,4,32,50,3,2,0,45,46,73,18,17,74
11X508,2012,115,87,71,0,9,3,32,68,11,1,0,47,68,89,26,17,98
11X508,2011,91,71,64,3,5,2,26,49,13,1,0,43,48,78,13,18,73
11X509,2017,109,104,104,16,2,18,5,65,21,0,0,46,63,97,12,5,104
11X509,2016,84,75,74,26,8,17,5,41,18,3,0,36,48,79,5,3,81
11X509,2015,96,72,67,22,11,14,4,65,12,1,0,47,49,90,6,5,91
11X509,2014,81,56,50,10,14,5,12,52,9,3,0,39,42,74,7,2,79
11X509,2013,78,52,49,13,8,18,4,47,8,1,0,44,34,77,1,1,77
11X509,2012,109,66,63,8,14,21,12,64,10,1,1,57,52,105,4,6,103
11X509,2011,89,58,57,15,8,15,11,51,8,4,0,43,46,85,4,1,88
11X513,2017,73,55,55,28,6,8,12,47,6,0,0,40,33,65,8,5,68
11X513,2016,83,75,75,26,5,7,13,51,12,0,0,47,36,76,7,4,79
11X513,2015,79,62,60,16,3,6,8,57,8,0,0,35,44,74,5,4,75
11X513,2014,70,63,63,12,2,9,14,35,9,3,0,37,33,69,1,1,69
11X513,2013,82,69,66,27,3,12,13,48,5,4,0,51,31,77,5,9,73
11X513,2012,75,58,56,9,5,7,7,54,5,2,0,43,32,73,2,5,70
11X513,2011,84,74,74,18,0,12,3,62,6,1,0,41,43,81,3,1,83
11X513,2010,69,48,47,14,5,6,8,54,0,1,0,32,37,69,0,3,66
11X513,2009,82,63,63,8,5,11,16,51,3,1,0,48,34,78,4,2,80
11X513,2008,73,48,47,8,6,12,8,49,4,0,0,37,36,70,3,1,72
11X513,2007,56,27,24,4,6,5,8,41,2,0,0,31,25,45,11,0,56
11X513,2006,62,46,36,16,2,5,9,41,7,0,0,30,32,55,7,0,62
11X513,2005,58,41,29,5,0,6,4,43,5,0,0,33,25,57,1,1,57
11X513,2004,86,67,40,17,2,9,12,55,8,1,1,41,45,80,6,3,83
11X514,2017,86,68,68,13,6,4,47,25,4,6,0,52,34,68,18,18,68
11X514,2016,104,74,74,6,16,3,69,27,2,3,0,64,40,70,34,17,87
11X514,2015,96,61,52,0,17,4,59,28,3,2,0,46,50,72,24,18,78
11X514,2014,100,59,51,4,16,3,64,30,2,1,0,50,50,69,31,14,86
11X514,2013,104,62,54,2,15,3,75,25,1,0,0,46,58,80,24,28,76
11X514,2012,101,64,58,4,11,7,61,22,8,2,1,52,49,58,43,18,83
11X514,2011,118,73,61,4,15,2,69,45,1,1,0,58,60,82,36,35,83
11X514,2010,95,64,55,3,6,3,60,29,1,2,0,37,58,59,36,20,75
11X514,2009,90,43,39,0,11,1,51,34,2,2,0,28,62,65,25,17,73
11X514,2008,98,42,34,0,22,2,60,35,1,0,0,34,64,66,32,18,80
11X514,2007,68,26,11,0,18,2,27,34,3,0,0,18,50,43,25,16,52
11X514,2006,66,33,13,0,10,2,28,39,1,1,0,11,55,54,12,13,53
11X514,2005,71,35,7,0,12,2,24,47,6,0,0,20,51,47,24,9,62
11X514,2004,79,61,21,2,1,0,36,31,0,1,0,40,39,44,35,14,65
11X541,2010,45,24,19,0,17,4,12,26,3,0,0,23,22,29,16,10,35
11X541,2009,109,43,40,0,35,4,37,61,6,1,0,34,75,87,22,19,90
11X541,2008,109,47,46,7,27,4,45,55,5,0,0,48,61,89,20,17,92
11X541,2007,103,58,41,6,14,3,38,59,3,0,0,48,55,84,19,20,83
11X541,2006,116,59,27,4,19,1,57,54,1,3,0,40,76,88,28,20,96
11X541,2005,110,57,7,0,12,2,43,60,3,1,1,45,65,87,23,23,87
11X541,2004,88,43,11,0,13,1,36,46,4,0,1,39,49,62,26,9,79
11X541,2003,88,63,20,0,6,3,38,45,1,0,1,49,39,66,22,7,81
11X542,2017,123,114,114,34,6,9,30,68,12,2,2,60,63,96,27,32,91
11X542,2016,122,115,97,37,3,13,23,65,19,1,1,59,63,93,29,27,95
11X542,2015,140,118,86,11,12,6,40,82,11,1,0,69,71,106,34,35,105
11X542,2014,134,120,102,17,5,12,46,61,5,5,5,88,46,100,34,16,118
11X542,2013,113,101,87,19,4,5,36,55,12,3,2,55,58,90,23,21,92
11X542,2012,120,106,97,19,5,4,42,66,7,1,0,57,63,87,33,25,95
11X542,2011,111,94,85,10,4,7,37,55,10,2,0,55,56,82,29,23,88
11X542,2010,96,85,79,4,4,5,45,44,2,0,0,47,49,59,37,13,83
11X542,2009,113,101,96,17,0,3,44,56,10,0,0,62,51,76,37,6,107
11X542,2008,93,78,72,15,2,1,42,41,9,0,0,53,40,63,30,12,81
11X542,2007,106,97,90,12,2,4,53,43,6,0,0,58,48,77,29,7,99
11X542,2006,111,99,85,16,4,6,38,53,9,1,4,62,49,74,37,8,103
11X542,2005,105,85,71,28,5,6,39,48,3,0,9,61,44,69,36,5,100
11X542,2004,97,83,59,16,7,4,53,34,2,1,3,64,33,73,24,2,95
11X542,2003,114,100,88,18,3,3,48,44,13,1,5,58,56,73,41,3,111
11X542,2002,88,74,58,7,2,7,29,44,8,0,0,47,41,64,24,2,86
11X544,2017,109,84,84,8,11,3,46,55,3,1,1,65,44,89,20,26,83
11X544,2016,120,96,95,1,7,2,45,66,6,1,0,68,52,97,23,26,94
11X544,2015,147,112,88,7,19,2,59,82,3,1,0,82,65,110,37,34,113
11X544,2014,120,88,57,5,8,1,49,65,3,1,1,57,63,93,27,30,90
11X544,2013,133,94,63,1,12,1,50,80,0,1,1,67,66,89,44,37,96
11X544,2012,124,71,54,1,12,2,55,85,1,1,0,50,74,90,34,40,84
11X544,2011,144,80,71,1,20,2,49,69,1,1,0,71,73,95,49,40,104
11X544,2010,118,80,78,0,12,2,43,62,0,3,0,55,63,90,28,28,90
11X544,2009,122,84,79,0,18,1,43,63,0,0,0,61,61,122,0,15,107
11X544,2008,110,69,66,0,15,5,57,51,1,2,0,43,67,110,0,15,95
11X544,2007,107,64,53,2,11,1,34,43,1,0,4,52,55,105,2,17,90
11X544,2006,118,71,49,2,3,0,50,71,1,2,0,65,53,115,3,23,95
11X544,2005,116,83,66,12,3,0,46,69,3,0,0,57,59,83,33,14,102
11X544,2004,81,69,57,19,4,0,60,54,1,2,1,45,36,73,8,9,72
11X544,2003,83,67,48,4,3,0,45,35,1,0,0,48,35,73,10,7,76
11X545,2017,79,62,62,4,13,7,32,37,2,0,1,23,56,68,11,18,61
11X545,2016,74,50,46,5,11,5,31,35,1,0,2,14,60,61,13,20,54
11X545,2015,86,53,37,0,14,2,43,40,1,0,0,20,66,62,24,21,65
11X545,2014,88,53,39,2,22,4,30,49,3,0,2,18,70,62,26,21,67
11X545,2013,88,57,41,0,12,2,23,57,3,2,1,14,74,51,37,28,60
11X545,2012,91,63,57,0,13,4,38,43,3,0,3,25,66,72,19,28,63
11X545,2011,103,70,56,0,15,2,23,76,2,0,0,23,80,87,16,32,71
11X545,2010,87,42,35,0,10,4,24,57,1,0,1,14,73,54,33,33,54
11X545,2009,84,61,47,0,10,2,19,66,2,1,0,11,73,84,0,31,53
11X545,2008,90,66,57,7,4,1,29,51,0,0,0,13,77,90,0,26,64
11X545,2007,81,63,49,1,9,2,21,47,0,0,0,15,66,80,1,20,61
11X545,2006,70,62,41,4,3,2,26,53,2,0,0,14,56,67,3,16,54
11X545,2005,83,76,30,0,2,2,29,42,0,0,0,18,65,49,34,10,73
11X545,2004,73,71,43,0,1,2,24,45,1,0,0,14,59,64,9,8,65
11X545,2003,72,64,34,1,1,3,27,28,2,0,0,19,53,58,14,11,61
11X545,2002,60,55,27,0,1,0,22,61,1,0,0,26,34,60,0,4,56
12X242,2017,93,84,84,30,2,5,15,73,0,0,0,44,49,81,12,21,72
12X242,2016,89,78,78,15,2,2,17,70,0,0,0,46,43,74,15,24,65
12X242,2015,99,80,73,25,6,10,12,76,1,0,0,48,51,82,17,24,75
12X242,2014,99,79,71,25,3,1,15,81,0,1,1,44,55,78,21,18,81
12X242,2013,83,66,62,21,2,5,16,58,2,2,0,41,42,69,14,17,66
12X242,2012,96,77,76,31,2,2,25,65,4,0,0,48,48,83,13,20,76
12X242,2011,79,57,55,22,3,7,28,41,1,2,0,46,33,68,11,13,66
12X242,2010,82,58,58,13,6,2,16,62,1,1,0,47,35,72,10,23,59
12X245,2010,12,0,0,0,12,2,19,28,0,0,0,3,9,9,3,4,8
12X245,2009,49,19,19,0,26,0,2,9,0,1,0,18,31,43,6,14,35
12X245,2008,72,22,22,0,26,0,37,35,0,0,0,39,33,51,21,17,55
12X245,2007,62,32,32,0,20,0,31,31,0,0,0,27,35,52,10,12,50
12X245,2006,72,20,20,0,18,0,29,43,0,0,0,38,34,58,14,12,60
12X245,2005,74,40,40,0,8,0,30,43,0,0,1,49,25,63,11,12,62
12X248,2017,82,59,59,36,22,1,28,81,1,2,1,37,45,80,2,22,60
12X248,2016,90,65,64,0,18,3,27,70,0,0,1,45,45,83,7,24,66
12X248,2015,114,62,44,0,29,1,24,58,1,1,2,48,66,108,6,36,78
12X248,2014,101,40,32,0,16,4,14,64,1,0,0,39,62,91,10,32,69
12X248,2013,91,41,33,5,11,1,26,69,1,0,0,39,52,72,19,30,61
12X248,2012,74,43,36,0,10,2,41,61,0,0,0,37,37,64,10,26,48
12X248,2011,87,52,49,3,10,1,38,55,1,1,0,39,48,80,7,27,60
12X248,2010,83,50,43,3,8,0,18,63,1,0,0,32,51,74,9,21,62
12X248,2009,97,67,58,2,18,0,19,70,0,1,0,52,45,86,11,26,71
12X248,2008,87,58,48,2,12,0,24,63,2,1,1,43,44,81,6,17,70
12X248,2007,81,55,47,0,10,0,9,65,0,0,0,41,40,70,11,15,66
12X248,2006,104,74,40,3,13,0,19,67,1,0,0,58,46,88,16,20,84
12X248,2005,96,70,43,4,15,0,19,62,0,0,0,45,51,74,22,12,84
12X248,2004,9,0,0,0,3,0,1,8,0,0,0,6,3,7,2,1,8
12X251,2017,57,43,43,1,6,1,20,35,0,1,0,29,28,51,6,13,44
12X251,2016,91,53,52,3,17,2,21,66,2,0,0,45,46,82,9,20,71
12X251,2015,100,64,46,7,18,2,33,63,1,0,1,42,58,91,9,21,79
12X251,2014,106,73,47,10,9,1,28,76,1,0,0,43,63,100,6,33,73
12X251,2013,79,52,38,0,12,1,20,56,1,1,0,32,47,73,6,20,59
12X251,2012,85,52,37,0,12,1,29,62,2,2,1,33,52,76,9,23,62
12X251,2011,92,51,43,0,19,3,32,66,1,0,0,42,50,83,9,22,70
12X251,2010,97,49,40,0,16,2,42,64,0,0,0,47,50,89,8,26,71
12X251,2009,102,45,40,2,24,0,23,59,3,0,0,54,48,93,9,23,79
12X251,2008,112,65,64,2,22,0,26,65,0,1,0,62,50,112,0,20,92
12X251,2007,108,66,55,8,15,0,32,77,2,1,0,48,60,107,1,20,88
12X251,2006,69,50,38,2,12,0,25,42,2,0,0,40,29,65,4,6,63
12X251,2005,81,48,36,4,18,0,23,57,1,0,0,43,38,58,23,12,69
12X262,2010,30,11,8,0,12,1,9,20,0,0,0,17,13,26,4,9,21
12X262,2009,67,11,9,0,22,1,29,52,1,3,0,52,15,56,11,21,46
12X262,2008,86,22,21,0,14,2,43,49,1,0,0,71,15,86,0,25,61
12X262,2007,95,11,8,0,16,2,38,46,0,0,0,62,33,93,2,27,68
12X262,2006,113,51,18,0,21,2,40,39,0,0,0,93,20,103,10,21,92
12X262,2005,86,48,14,0,17,0,28,38,1,0,0,65,21,42,44,5,81
12X262,2004,81,36,18,0,15,0,56,56,1,0,0,63,18,72,9,12,69
12X262,2003,10,0,0,0,4,0,3,7,0,0,0,7,3,6,4,2,8
12X267,2017,75,70,70,49,4,2,15,65,1,0,0,31,44,69,6,20,55
12X267,2016,83,78,78,46,1,2,17,72,0,0,0,42,41,81,2,23,60
12X267,2015,91,82,71,18,2,1,19,61,0,0,0,39,52,85,6,18,73
12X267,2014,81,75,70,30,1,2,12,48,0,0,0,39,42,76,5,17,64
12X267,2013,71,68,61,28,1,1,11,36,2,0,0,37,34,69,2,12,59
12X267,2012,62,56,52,17,3,0,13,61,0,0,1,37,25,57,5,16,46
12X267,2011,58,49,43,7,4,0,13,58,0,0,0,29,29,52,6,11,47
12X267,2010,56,50,45,16,2,0,16,42,0,0,0,28,28,47,9,13,43
12X267,2009,40,29,28,3,6,0,13,43,0,0,0,22,18,38,2,12,28
12X267,2008,50,38,37,14,4,0,11,28,1,0,0,26,24,46,4,12,38
12X267,2007,40,31,31,8,7,0,18,22,0,0,0,22,18,40,0,3,37
12X271,2017,106,83,83,12,11,4,29,68,0,5,0,45,61,92,14,29,77
12X271,2016,96,78,77,5,6,3,22,68,2,0,1,34,62,82,14,28,68
12X271,2015,114,81,74,6,12,1,31,63,1,0,0,67,47,103,11,39,75
12X271,2014,96,70,59,2,5,3,23,70,2,0,1,52,44,84,12,37,59
12X271,2013,97,74,53,3,6,5,26,66,1,0,0,46,51,85,12,25,72
12X271,2012,99,83,68,2,3,2,23,65,0,0,0,51,48,90,9,37,62
12X271,2011,98,68,61,4,12,2,24,62,0,0,0,54,44,77,21,31,67
12X271,2010,90,65,58,2,8,3,42,43,2,0,0,39,51,76,14,21,69
12X271,2009,103,65,61,3,15,2,19,50,3,0,0,46,57,83,20,23,80
12X271,2008,88,63,60,2,9,1,32,44,3,0,0,35,53,64,24,25,63
12X271,2007,90,63,55,0,8,1,30,36,0,0,0,44,46,72,18,22,68
12X271,2006,74,50,43,0,9,0,21,91,0,0,2,24,50,64,10,21,53
12X271,2005,80,44,19,4,11,0,29,68,0,0,0,33,47,58,22,13,67
12X271,2004,67,47,17,1,8,0,25,76,0,2,0,37,30,50,17,5,62
12X271,2003,7,0,0,0,4,0,4,3,0,0,0,3,4,5,2,0,7
12X278,2013,8,0,0,0,8,3,32,40,2,0,0,3,5,5,3,2,6
12X278,2012,22,9,9,0,12,1,21,46,0,2,0,9,13,19,3,6,16
12X278,2011,57,13,13,0,18,1,33,60,1,1,0,29,28,48,9,16,41
12X278,2010,62,21,19,0,6,1,19,60,2,0,1,37,25,58,4,19,43
12X278,2009,67,23,23,0,17,0,3,5,0,0,0,42,25,60,7,11,56
12X278,2008,77,25,25,1,19,0,8,13,1,0,0,40,37,66,11,14,63
12X278,2007,70,30,29,4,8,0,27,28,0,1,1,37,33,59,11,6,64
12X278,2006,96,47,40,0,15,0,32,30,0,0,0,50,46,72,24,15,81
12X278,2005,31,17,17,0,10,0,29,38,0,0,0,17,14,18,13,3,28
12X278,2004,83,50,50,0,4,0,11,17,3,0,0,45,38,59,24,13,70
12X321,2012,14,4,4,0,9,2,25,44,0,2,2,10,4,13,1,3,11
12X321,2011,35,4,4,0,6,2,25,29,0,0,0,24,11,34,1,2,33
12X321,2010,46,8,7,0,4,1,23,23,0,0,0,33,13,42,4,1,45
12X321,2009,75,19,18,0,13,0,6,8,0,0,0,55,20,67,8,3,72
12X321,2008,51,13,12,0,12,0,21,25,0,0,0,34,17,43,8,6,45
12X321,2007,49,3,3,0,15,0,26,24,1,0,0,28,21,45,4,4,45
12X321,2006,56,8,5,0,10,0,28,18,3,0,0,34,22,41,15,3,53
12X321,2005,50,4,3,0,10,0,14,35,1,0,0,33,17,38,12,7,43
12X321,2004,47,6,4,0,5,0,33,32,0,0,0,31,16,31,16,4,43
12X321,2003,65,9,5,0,25,0,21,33,0,0,0,40,25,44,21,4,61
12X321,2002,54,4,2,0,17,0,3,7,0,0,0,32,22,35,19,4,50
12X321,2001,10,0,0,0,1,0,0,0,1,1,0,7,3,3,7,0,10
12X372,2015,6,0,0,0,5,5,22,50,5,1,0,31,42,6,0,13,60
12X372,2014,73,55,47,0,9,4,15,42,4,0,0,43,51,55,18,18,76
12X372,2013,94,64,51,0,7,0,3,1,0,0,0,43,36,55,39,19,60
12X372,2012,79,57,51,1,7,0,2,4,0,0,0,38,45,49,30,16,67
12X372,2011,83,64,52,3,3,0,25,66,2,0,1,33,32,51,32,17,48
12X372,2010,65,43,35,0,2,0,1,1,0,0,0,0,4,38,27,1,1
12X388,2017,84,75,75,0,8,0,1,111,0,0,0,40,44,81,3,0,84
12X388,2016,112,95,95,0,8,0,0,83,0,1,0,61,51,106,6,2,110
12X388,2015,117,92,89,0,10,0,0,117,0,0,0,57,60,117,0,3,114
12X388,2014,99,73,71,0,15,0,0,99,0,0,0,45,54,94,5,1,98
12X388,2013,78,57,55,0,6,0,0,78,0,0,0,33,45,74,4,4,74
12X388,2012,61,50,48,0,9,0,0,61,0,0,0,31,30,58,3,0,61
12X388,2011,89,72,69,0,5,0,0,89,0,0,0,40,49,87,2,2,87
12X388,2010,107,61,61,5,9,0,0,107,0,0,0,55,52,102,5,0,107
12X388,2009,71,38,38,0,3,0,0,71,0,0,0,37,34,70,1,0,71
12X388,2008,50,27,27,0,4,0,0,50,0,0,0,24,26,47,3,0,50
12X446,2017,87,18,18,0,6,1,30,55,0,1,0,46,41,78,9,29,58
12X446,2016,88,20,20,0,8,2,25,57,3,0,1,54,34,82,6,28,60
12X446,2015,104,22,20,0,21,1,32,60,2,0,0,59,45,84,20,23,81
12X446,2014,95,11,10,0,24,1,33,56,3,2,0,55,40,82,13,14,81
12X446,2013,83,12,12,0,14,1,41,55,1,0,0,54,29,59,24,9,74
12X446,2012,95,5,5,0,19,2,44,84,1,0,0,62,33,74,21,12,83
12X446,2011,79,13,12,0,11,1,41,75,0,0,0,54,25,69,10,14,65
12X446,2010,98,11,11,0,6,0,37,63,4,0,0,64,34,80,18,9,89
12X446,2009,131,20,19,0,24,0,34,46,2,1,0,99,32,113,18,16,115
12X446,2008,117,11,10,0,25,0,30,47,1,0,1,84,33,100,17,12,105
12X446,2007,136,4,2,0,32,0,68,66,0,2,0,88,48,105,31,8,128
12X478,2017,78,70,70,20,1,3,12,57,3,3,0,49,29,62,16,13,65
12X478,2016,66,52,52,10,1,1,10,46,2,8,0,32,34,54,12,16,50
12X478,2015,67,60,52,3,0,1,14,49,2,1,1,43,24,49,18,12,55
12X478,2014,68,56,55,0,1,2,14,49,3,0,0,37,31,59,9,8,60
12X478,2013,68,59,59,3,0,2,18,55,3,0,0,46,22,56,12,1,67
12X478,2012,78,63,60,6,2,7,19,65,3,0,0,46,32,61,17,6,72
12X478,2011,94,89,88,4,2,4,18,32,3,0,1,52,42,75,19,3,91
12X478,2010,58,50,50,7,3,5,24,45,0,0,0,33,25,48,10,3,55
12X478,2009,74,71,70,16,2,0,9,53,1,3,0,40,34,65,9,2,72
12X479,2017,65,50,49,23,8,2,25,36,0,2,0,30,35,59,6,18,47
12X479,2016,75,41,36,4,19,2,18,54,1,0,0,38,37,65,10,21,54
12X479,2015,83,39,34,1,17,2,35,45,0,1,0,39,44,67,16,9,74
12X479,2014,90,50,37,2,21,1,34,50,0,0,1,44,46,76,14,25,65
12X479,2013,86,34,30,0,20,1,37,51,0,0,2,48,38,77,9,30,56
12X479,2012,91,37,35,0,19,1,33,56,1,0,0,48,43,76,15,22,69
12X479,2011,91,40,37,0,15,2,21,46,0,0,0,46,45,85,6,36,55
12X479,2010,74,33,28,0,20,0,41,45,4,0,0,35,39,61,13,27,47
12X479,2009,69,40,39,0,6,0,34,40,0,0,0,43,26,55,14,8,61
12X480,2017,53,9,7,0,6,3,22,26,2,0,0,26,27,49,4,9,44
12X480,2016,84,12,10,1,5,2,36,44,1,1,0,50,34,75,9,15,69
12X480,2015,77,7,7,0,16,1,25,50,1,0,0,45,32,67,10,13,64
12X480,2014,93,8,8,0,14,1,27,62,3,0,0,51,42,82,11,11,82
12X480,2013,65,5,5,0,19,1,23,40,1,0,0,31,34,55,10,9,56
12X480,2012,106,3,3,0,19,2,39,64,1,0,0,62,44,90,16,14,92
12X480,2011,106,8,8,0,23,1,29,74,1,0,1,69,37,87,19,6,100
12X480,2010,107,13,11,0,8,3,49,66,1,1,0,80,27,97,10,22,85
12X480,2009,120,11,10,0,34,1,61,92,1,1,2,71,49,90,30,16,104
12X480,2008,158,26,21,0,43,3,61,93,0,0,1,105,53,131,27,12,146
12X480,2007,158,29,18,2,42,1,45,63,1,0,0,102,56,129,29,17,141
12X480,2006,107,28,15,0,7,1,71,57,3,2,0,63,44,92,15,14,93
12X480,2005,119,26,10,0,11,2,97,62,2,0,0,70,49,98,21,15,104
12X480,2004,110,30,4,0,11,0,48,59,0,0,0,66,44,95,15,12,98
12X480,2003,111,21,5,0,10,0,43,63,1,0,0,71,40,99,12,17,94
12X480,2002,134,19,3,0,9,0,52,67,0,0,0,76,58,109,25,16,118
12X480,2001,163,17,2,0,22,0,49,60,1,0,1,91,72,116,47,25,138
12X511,2017,102,88,88,30,6,3,35,62,1,1,0,61,41,94,8,23,79
12X511,2016,98,60,60,4,13,1,38,56,2,1,0,55,43,80,18,26,72
12X511,2015,107,75,62,9,11,2,36,66,1,2,0,71,36,93,14,28,79
12X511,2014,90,62,54,2,13,4,26,57,2,1,0,57,33,83,7,16,74
12X511,2013,88,57,41,1,19,1,33,53,1,0,0,44,44,67,21,17,71
12X511,2012,88,59,49,3,11,2,32,43,3,0,1,49,39,73,15,16,72
12X511,2011,81,56,45,1,8,0,31,54,2,1,0,48,33,68,13,16,65
12X521,2017,101,76,76,12,12,5,20,59,3,0,0,50,51,90,11,24,77
12X521,2016,87,62,62,5,10,2,34,68,2,2,0,37,50,75,12,20,67
12X521,2015,108,72,59,2,17,4,22,88,2,3,0,52,56,96,12,25,83
12X521,2014,119,79,69,3,17,3,33,69,4,1,1,55,64,115,4,27,92
12X521,2013,111,67,62,5,17,4,30,86,3,2,1,47,64,106,5,26,85
12X521,2012,126,91,80,4,14,1,33,62,1,2,1,69,57,117,9,30,96
12X521,2011,100,72,70,7,6,0,23,75,1,2,0,40,60,83,17,15,85
12X550,2017,131,118,118,24,9,6,14,104,7,0,0,63,68,128,3,6,125
12X550,2016,126,104,104,16,11,7,11,100,3,4,1,59,67,119,7,4,122
12X550,2015,114,62,62,7,19,14,6,89,3,2,0,55,59,105,9,4,110
12X550,2014,101,43,42,2,21,9,3,86,3,0,0,44,57,96,5,0,101
12X550,2013,78,30,27,1,14,9,5,62,0,2,0,41,37,74,4,0,78
12X550,2012,104,45,43,1,17,6,17,79,1,1,0,46,58,93,11,0,104
12X550,2011,101,48,48,2,13,7,5,82,0,7,0,42,59,97,4,0,101
12X550,2010,79,43,43,2,15,1,5,71,0,1,1,39,40,77,2,0,79
12X550,2009,114,37,35,6,10,2,14,96,1,1,0,54,60,105,9,0,114
12X550,2008,96,34,34,2,9,1,10,85,0,0,0,50,46,94,2,1,95
12X550,2007,97,51,38,4,7,1,12,84,0,0,0,43,54,95,2,0,97
12X550,2006,52,36,18,2,1,4,3,45,0,0,0,31,21,49,3,0,52
12X550,2005,91,60,41,6,2,4,7,80,0,0,0,47,44,88,3,0,91
12X550,2004,61,42,32,2,3,4,2,47,0,0,0,37,24,56,5,0,61
12X550,2003,53,37,23,0,1,2,8,54,0,0,0,30,23,45,8,0,53
12X550,2002,46,21,5,0,5,0,3,58,0,0,0,25,21,27,19,0,46
12X550,2001,64,19,2,0,7,0,5,41,0,0,0,28,36,29,35,0,64
12X680,2007,59,35,28,0,19,3,20,36,0,0,0,16,43,42,17,16,43
12X680,2006,99,50,33,0,22,3,39,63,2,0,0,24,75,78,21,21,78
12X680,2005,107,49,30,2,16,5,38,57,1,0,1,28,79,95,12,22,85
12X680,2004,102,44,14,0,16,1,35,64,1,1,0,29,73,86,16,15,87
12X680,2003,102,41,14,0,18,0,36,62,1,0,0,39,63,81,21,25,77
12X680,2002,93,29,5,0,21,0,36,55,1,1,0,33,60,62,31,16,77
12X680,2001,97,47,42,0,23,0,38,58,1,0,0,40,57,78,19,22,75
12X682,2017,113,92,92,0,5,1,44,66,2,0,0,60,53,97,16,41,72
12X682,2016,107,72,71,0,13,1,28,75,0,2,1,41,66,90,17,35,72
12X682,2015,122,86,80,0,16,1,40,68,0,0,0,58,64,100,22,37,85
12X682,2014,119,77,70,0,24,1,43,84,0,0,0,48,71,94,25,34,85
12X682,2013,109,72,69,0,19,1,35,76,1,0,0,50,59,77,32,32,77
12X682,2012,128,84,76,0,18,1,35,83,0,0,0,64,64,103,25,30,98
12X682,2011,108,71,69,0,10,2,43,59,0,1,0,54,54,81,27,34,74
12X682,2010,124,78,75,0,18,0,34,85,1,2,0,48,76,91,33,27,97
12X682,2009,133,80,71,0,12,0,27,91,0,1,0,64,69,133,0,36,97
12X682,2008,113,63,60,0,13,0,36,71,0,1,0,54,59,113,0,32,81
12X682,2007,133,79,70,0,22,0,36,87,0,1,0,71,62,133,0,36,97
12X682,2006,119,72,64,0,9,0,40,93,0,0,0,60,59,118,1,30,89
12X682,2005,105,69,58,0,8,0,37,93,2,1,0,58,47,104,1,34,71
12X682,2004,93,63,54,0,9,0,32,59,1,1,0,49,44,92,1,17,76
12X682,2003,133,75,21,0,15,0,46,85,1,1,0,64,69,130,3,26,107
12X682,2002,81,49,0,0,10,0,29,51,1,0,0,44,37,77,4,18,63
12X682,2001,81,49,5,0,11,0,23,57,1,0,0,54,27,76,5,24,57
12X684,2017,87,59,59,8,12,1,52,29,2,0,3,36,51,76,11,17,70
12X684,2016,131,68,62,3,14,2,42,44,2,0,1,45,86,117,14,47,84
12X684,2015,93,49,41,0,17,1,63,37,1,3,2,40,53,81,12,30,63
12X684,2014,91,41,33,2,18,2,69,49,2,0,1,33,58,75,16,25,66
12X684,2013,107,50,43,1,22,2,60,43,3,0,1,43,64,78,29,23,84
12X684,2012,123,58,52,3,17,3,45,44,1,0,0,54,69,95,28,28,95
12X684,2011,119,64,59,4,10,2,67,55,0,0,0,55,64,89,30,32,87
12X684,2010,109,65,54,1,11,4,66,67,2,0,0,56,53,94,15,25,84
12X684,2009,93,56,52,6,18,1,48,65,0,2,0,44,49,75,18,18,75
12X684,2008,124,62,59,9,13,4,57,58,1,2,0,61,63,100,24,26,98
12X684,2007,139,64,57,2,16,4,53,69,0,3,0,73,66,93,46,19,120
12X684,2006,116,77,57,8,12,1,51,63,2,1,1,57,59,88,28,17,99
12X684,2005,122,79,59,5,11,2,41,44,2,0,0,67,55,121,1,22,100
12X684,2004,129,69,47,5,12,1,41,38,3,0,0,63,66,127,2,27,102
12X684,2003,119,58,43,7,14,0,75,52,0,2,2,59,60,116,3,19,100
12X684,2002,89,51,45,0,7,0,46,45,1,0,1,47,42,41,48,14,75
12X684,2001,83,37,25,0,10,0,65,50,3,1,0,46,37,54,29,13,70
12X690,2010,30,13,9,0,13,2,1,27,0,0,0,12,18,25,5,7,23
12X690,2009,92,29,29,2,20,3,26,60,1,2,0,37,55,86,6,14,78
12X690,2008,95,35,34,4,22,1,31,62,0,1,0,39,56,80,15,15,80
12X690,2007,117,39,27,1,45,1,27,88,1,0,0,52,65,91,26,19,98
12X690,2006,137,65,43,4,36,1,35,70,5,0,0,62,75,102,35,24,113
12X690,2005,140,68,40,7,27,5,48,86,0,0,0,62,78,113,27,25,115
12X690,2004,111,49,31,2,23,1,40,58,0,2,0,57,54,88,23,19,92
12X690,2003,139,61,37,0,22,2,35,68,0,1,0,75,64,106,33,24,115
12X690,2002,101,44,19,0,22,0,39,97,0,1,0,50,51,68,33,13,88
12X690,2001,106,37,11,0,27,0,45,92,2,1,0,55,51,72,34,11,95
12X692,2015,9,0,0,0,8,1,23,71,1,1,2,6,9,8,1,4,5
12X692,2014,15,1,1,0,14,1,27,79,0,1,1,38,42,14,1,7,8
12X692,2013,80,50,39,0,16,2,18,95,1,0,0,46,53,72,8,22,58
12X692,2012,99,38,36,2,17,1,26,73,3,0,0,48,61,90,9,20,79
12X692,2011,109,54,46,0,19,2,14,91,0,0,0,49,56,98,11,30,79
12X692,2010,105,44,42,0,18,4,31,72,3,1,1,49,67,90,15,20,85
12X692,2009,116,48,46,1,21,0,2,7,0,0,0,58,45,105,11,23,93
12X692,2008,103,37,35,0,18,0,2,12,0,1,0,63,44,95,8,26,77
12X692,2007,107,41,34,5,19,0,17,86,2,0,0,61,51,92,15,14,93
12X692,2006,112,53,43,4,13,0,28,89,1,0,0,46,72,99,13,26,86
12X692,2005,118,33,24,3,10,0,23,63,0,0,0,42,44,97,21,33,85
12X692,2004,86,32,25,3,16,0,35,79,3,0,0,55,62,65,21,20,66
12X692,2003,117,39,26,0,34,0,34,69,2,0,0,44,61,82,35,25,92
12X692,2002,105,38,16,0,26,0,20,59,1,0,0,34,46,66,39,12,93
12X692,2001,80,20,3,0,17,0,0,1,0,0,0,0,1,44,36,13,67
13K265,2017,54,33,33,0,0,3,36,13,0,2,0,27,27,44,10,19,35
13K265,2016,53,43,41,9,2,2,42,7,1,0,1,27,26,43,10,16,37
13K265,2015,55,35,30,1,1,2,38,15,0,0,0,31,24,49,6,14,41
13K265,2014,48,33,31,5,1,1,33,12,0,1,1,27,21,42,6,11,37
13K265,2013,66,42,34,2,2,1,45,18,1,0,1,43,23,56,10,19,47
13K265,2012,91,63,56,0,2,1,54,16,1,0,0,54,37,69,22,15,76
13K265,2011,69,34,29,0,6,1,88,10,1,0,0,48,21,56,13,12,57
13K265,2010,73,43,40,0,5,1,43,3,2,0,0,52,21,58,15,7,66
13K265,2009,73,42,41,8,1,1,48,14,3,0,0,48,25,64,9,5,68
13K265,2008,39,28,25,4,2,0,75,13,0,0,3,23,16,28,11,10,29
13K265,2007,72,56,51,8,9,0,45,21,0,0,3,50,22,55,17,8,64
13K265,2006,81,66,45,0,3,0,56,13,2,0,2,55,26,63,18,5,76
13K265,2005,100,46,38,0,9,0,58,14,1,0,0,59,41,64,36,15,85
13K265,2004,49,35,30,0,3,0,30,9,0,0,0,28,21,36,13,4,45
13K265,2003,73,55,41,0,6,0,66,14,0,1,0,42,31,68,5,8,65
13K265,2002,66,48,34,0,9,0,60,13,0,0,0,45,21,66,0,5,61
13K265,2001,23,20,8,0,0,0,17,5,1,0,0,11,12,23,0,1,22
13K336,2009,6,4,4,0,2,1,4,1,0,0,0,0,6,6,0,1,5
13K336,2008,21,8,8,0,3,0,19,2,0,0,0,0,21,21,0,6,15
13K350,2017,23,18,18,0,3,1,35,12,0,0,1,16,7,20,3,7,16
13K350,2016,49,43,38,0,3,2,63,19,0,0,0,32,17,39,10,9,40
13K350,2015,50,42,30,0,3,1,70,22,2,2,0,34,16,45,5,12,38
13K350,2014,50,38,28,0,0,3,63,22,1,0,0,36,14,42,8,11,39
13K350,2013,49,37,28,0,1,1,58,26,0,2,0,35,14,43,6,13,36
13K350,2012,80,63,56,0,4,5,62,22,1,0,1,46,34,66,14,11,69
13K350,2011,98,52,43,0,18,0,13,8,2,0,0,52,46,74,24,29,69
13K350,2010,84,47,42,0,10,0,45,4,0,0,1,53,31,69,15,18,66
13K350,2009,97,42,31,0,20,0,35,12,2,0,1,63,34,71,26,23,74
13K350,2008,89,46,36,0,12,0,33,15,1,0,0,43,46,72,17,21,68
13K350,2007,87,43,32,0,4,0,64,15,1,0,0,41,46,69,18,12,75
13K350,2006,96,69,50,0,7,0,76,21,1,0,0,53,43,72,24,8,88
13K350,2005,91,64,41,0,8,0,78,16,0,2,0,52,39,68,23,8,83
13K412,2017,128,110,110,4,6,2,92,34,0,0,0,73,55,103,25,36,92
13K412,2016,100,87,86,0,6,1,69,26,2,1,1,52,48,85,15,22,78
13K412,2015,87,65,56,0,9,1,67,18,0,1,0,59,28,75,12,18,69
13K412,2014,88,55,47,0,14,1,71,16,0,0,0,41,47,72,16,20,68
13K412,2013,89,62,57,0,12,1,70,14,1,2,1,50,39,71,18,24,65
13K412,2012,83,54,50,0,9,1,68,13,0,0,1,50,33,64,19,12,71
13K412,2011,118,80,73,0,11,1,74,12,2,0,0,71,47,97,21,24,94
13K412,2010,103,69,55,1,11,1,92,11,0,0,0,51,52,87,16,24,79
13K412,2009,108,71,64,1,16,0,93,20,1,4,0,58,50,89,19,16,92
13K412,2008,89,49,45,0,8,0,71,26,4,2,0,45,44,61,28,10,79
13K412,2007,104,60,43,2,5,0,90,16,0,2,0,58,46,76,28,19,85
13K412,2006,78,39,30,5,2,0,64,12,1,1,0,35,43,57,21,16,62
13K419,2017,154,150,150,45,1,15,101,29,5,1,3,62,92,124,30,16,138
13K419,2016,119,115,115,24,0,6,81,23,5,1,3,45,74,99,20,12,107
13K419,2015,110,102,95,10,3,4,86,15,4,0,1,54,56,85,25,17,93
13K419,2014,139,116,109,11,6,13,97,25,1,0,3,66,73,104,35,16,123
13K419,2013,116,86,80,8,7,5,84,22,3,0,2,53,63,93,23,23,93
13K419,2012,139,108,104,10,4,12,94,28,3,0,2,59,80,106,33,18,121
13K419,2011,91,63,59,8,11,3,76,12,0,0,0,44,47,77,14,13,78
13K419,2010,102,66,65,23,14,10,78,11,2,1,0,51,51,76,26,14,88
13K419,2009,137,88,86,16,10,12,103,18,4,0,0,60,77,101,36,25,112
13K419,2008,140,90,85,20,9,13,105,16,3,2,1,57,83,104,36,15,125
13K419,2007,234,168,160,36,13,18,185,26,5,0,0,89,145,155,79,28,206
13K419,2006,231,137,108,20,17,10,196,22,2,1,0,88,143,156,75,30,201
13K419,2005,243,162,140,23,17,14,197,26,4,2,0,105,138,159,84,14,229
13K419,2004,176,119,87,5,10,9,150,15,1,1,0,81,95,118,58,14,162
13K419,2003,186,117,85,0,15,14,146,23,3,0,0,88,98,113,73,10,176
13K419,2002,171,106,87,0,9,6,142,12,11,0,0,85,86,64,107,7,164
13K419,2001,180,113,85,0,15,4,141,17,18,0,0,92,88,116,64,5,175
13K430,2017,1476,1380,1380,1336,6,902,72,91,378,7,26,590,886,893,583,24,1452
13K430,2016,1517,1440,1440,1386,5,931,93,117,356,11,9,612,905,947,570,13,1504
13K430,2015,1417,1340,1340,1237,5,866,96,108,336,3,8,587,830,878,539,14,1403
13K430,2014,1322,1263,1263,1149,1,830,101,86,265,2,38,522,800,845,477,24,1298
13K430,2013,1315,1256,1256,1174,5,823,90,92,266,5,39,573,742,876,439,24,1291
13K430,2012,1370,1309,1309,1207,2,797,109,111,259,8,86,575,795,885,485,22,1348
13K430,2011,1330,1255,1255,1172,4,802,113,117,285,6,7,534,796,889,441,14,1316
13K430,2010,1297,1230,1230,1120,5,822,124,93,252,3,3,530,767,873,424,16,1281
13K430,2009,1300,1236,1236,1125,3,789,128,108,274,1,0,566,734,795,505,9,1291
13K430,2008,1261,1155,1155,1062,7,752,158,84,263,2,2,552,709,955,306,9,1252
13K430,2007,1126,1045,1045,953,0,682,120,95,229,0,0,446,680,732,394,14,1112
13K430,2006,1097,1003,1003,898,2,627,157,96,210,2,5,473,624,740,357,9,1088
13K430,2005,1011,903,903,835,4,564,140,77,225,2,3,421,590,598,413,10,1001
13K430,2004,1009,931,931,848,4,518,151,89,246,1,4,447,562,545,464,5,1004
13K430,2003,900,820,819,708,14,427,136,71,206,0,60,371,529,414,486,3,897
13K430,2002,919,864,864,767,9,437,138,64,278,1,1,354,565,280,639,3,916
13K430,2001,867,788,787,721,3,391,138,84,254,0,0,384,483,270,597,6,861
13K439,2017,96,77,77,0,5,30,14,41,11,0,0,40,56,92,4,3,93
13K439,2016,82,66,66,0,10,16,24,28,14,0,0,38,44,66,16,3,79
13K439,2015,105,71,68,0,11,24,21,49,11,0,0,57,48,82,23,7,98
13K439,2014,77,57,57,0,12,22,15,29,11,0,0,37,40,64,13,2,75
13K439,2013,94,73,68,0,6,35,19,22,18,0,0,40,54,40,54,3,91
13K439,2012,86,69,68,0,5,34,18,25,9,0,0,46,40,49,37,2,84
13K439,2011,82,71,71,0,5,51,13,9,9,0,0,48,34,57,25,1,81
13K439,2010,84,71,71,0,4,42,17,21,4,0,0,44,40,55,29,0,84
13K439,2009,98,74,74,0,5,29,27,36,6,0,0,54,44,98,0,0,98
13K439,2008,92,72,72,0,9,27,18,35,12,0,0,45,47,92,0,0,92
13K439,2007,94,73,73,0,7,24,16,46,8,0,0,47,47,93,1,0,94
13K439,2006,115,94,94,0,5,49,16,31,19,0,0,53,62,115,0,0,115
13K439,2005,87,74,53,0,2,25,25,30,7,0,0,44,43,87,0,0,87
13K439,2004,82,65,33,0,3,28,14,29,11,0,0,40,42,81,1,0,82
13K439,2003,65,50,16,0,6,18,20,19,8,0,0,30,35,60,5,1,64
13K439,2002,71,55,22,0,4,30,13,16,12,0,0,43,28,69,2,0,71
13K439,2001,72,59,21,0,4,32,13,19,8,0,0,41,31,63,9,1,71
13K483,2017,108,98,98,0,2,2,79,23,1,2,1,54,54,84,24,19,89
13K483,2016,104,100,100,0,0,2,68,29,2,2,1,46,58,74,30,12,92
13K483,2015,96,92,85,0,2,2,72,18,1,0,3,61,35,59,37,14,82
13K483,2014,111,103,95,0,5,4,71,33,0,1,2,55,56,86,25,16,95
13K483,2013,110,99,89,0,5,2,82,22,1,0,3,57,53,84,26,18,92
13K483,2012,105,98,93,0,0,3,75,19,1,0,7,67,38,84,21,10,95
13K483,2011,105,89,89,0,2,1,75,24,3,1,1,55,50,78,27,16,89
13K483,2010,107,92,92,0,3,1,79,16,1,0,0,60,47,72,35,12,95
13K483,2009,97,83,80,0,4,3,84,18,0,0,0,70,27,72,25,9,88
13K483,2008,105,92,86,0,3,1,74,12,1,0,0,71,34,83,22,15,90
13K483,2007,88,76,63,0,4,1,86,21,0,1,0,66,22,68,20,10,78
13K483,2006,109,92,78,28,2,3,84,16,1,0,0,83,26,85,24,14,95
13K483,2005,104,88,61,0,1,0,92,14,0,1,0,73,31,73,31,7,97
13K483,2004,86,77,58,0,0,0,53,27,2,0,4,54,32,63,23,4,82
13K499,2016,33,19,15,0,4,2,38,2,1,0,1,11,22,29,4,9,24
13K499,2015,44,31,24,0,3,2,60,8,1,0,0,23,21,38,6,10,34
13K499,2014,69,49,38,0,6,1,111,17,1,0,0,28,41,62,7,22,47
13K499,2013,71,54,40,1,6,1,131,15,2,1,0,35,36,54,17,24,47
13K499,2012,130,89,70,1,20,4,146,22,2,2,0,59,71,100,30,36,94
13K499,2011,150,68,63,2,23,2,132,22,1,2,0,64,86,121,29,32,118
13K499,2010,176,114,105,5,6,1,117,14,0,2,0,79,97,152,24,27,149
13K499,2009,159,107,103,7,12,4,138,28,2,1,1,77,82,143,16,26,133
13K499,2008,134,90,85,4,8,1,138,30,0,0,0,56,78,120,14,21,113
13K499,2007,174,115,107,6,22,4,133,29,3,3,0,83,91,144,30,22,152
13K499,2006,169,124,94,2,14,2,85,23,3,0,0,79,90,142,27,28,141
13K499,2005,172,106,81,12,13,0,27,4,1,0,1,99,73,138,34,30,142
13K499,2004,113,78,50,5,6,0,54,12,1,1,1,67,46,84,29,14,99
13K499,2003,131,79,59,2,25,0,112,19,0,0,0,79,52,102,29,22,109
13K499,2002,125,83,47,2,18,0,90,31,3,1,0,70,55,104,21,14,111
13K499,2001,120,68,31,0,20,0,94,22,4,0,0,70,50,103,17,12,108
13K509,2010,8,0,0,0,7,1,40,17,0,0,0,4,4,6,2,3,5
13K509,2009,54,25,21,0,13,1,48,8,1,0,0,33,21,39,15,9,45
13K509,2008,58,24,22,1,11,4,49,10,0,2,0,32,26,41,17,14,44
13K509,2007,57,27,24,1,7,1,40,9,2,0,0,28,29,41,16,11,46
13K509,2006,58,36,32,6,3,1,23,7,2,0,0,26,32,52,6,13,45
13K509,2005,65,28,25,2,2,1,13,2,0,0,0,30,35,59,6,11,54
13K509,2004,52,28,27,0,3,0,1,0,0,0,0,33,19,32,20,5,47
13K509,2003,49,22,20,0,5,0,5,3,0,0,0,26,23,22,27,2,47
13K509,2002,33,23,21,0,0,0,49,5,3,0,0,20,13,29,4,5,28
13K509,2001,16,11,10,0,1,0,40,8,0,0,1,10,6,12,4,3,13
13K527,2017,61,59,59,1,1,9,30,10,11,1,0,61,0,47,14,11,50
13K527,2016,74,69,63,13,3,7,45,13,8,1,0,74,0,62,12,8,66
13K527,2015,70,56,45,4,1,3,48,8,9,1,1,70,0,54,16,13,57
13K527,2014,68,57,49,4,3,2,48,9,9,0,0,68,0,57,11,13,55
13K527,2013,69,53,48,0,5,4,53,8,3,0,1,69,0,51,18,10,59
13K527,2012,63,43,39,1,0,1,58,10,1,2,1,63,0,42,21,9,54
13K527,2011,73,62,59,0,4,2,55,5,1,0,0,73,0,55,18,9,64
13K527,2010,55,46,44,5,1,0,50,9,4,0,0,55,0,46,9,6,49
13K527,2009,63,45,44,4,2,0,40,6,9,0,0,63,0,43,20,7,56
13K553,2017,53,5,5,0,2,1,76,12,0,0,0,24,29,48,5,10,43
13K553,2016,69,9,8,0,6,1,47,16,0,2,1,32,37,61,8,29,40
13K553,2015,89,10,5,0,28,2,57,9,0,2,0,50,39,75,14,20,69
13K553,2014,67,7,7,0,7,1,95,14,2,2,1,31,36,56,11,22,45
13K553,2013,54,13,12,1,7,0,39,11,1,2,0,33,21,48,6,9,45
13K553,2012,67,11,10,0,13,0,50,17,2,0,0,34,33,60,7,17,50
13K553,2011,70,18,14,1,6,0,37,14,0,3,0,38,32,62,8,11,59
13K553,2010,60,18,16,0,7,0,54,9,1,3,0,38,22,52,8,10,50
13K553,2009,70,10,9,0,8,0,60,8,1,1,0,46,24,61,9,7,63
13K553,2008,64,13,11,0,9,0,51,8,1,0,0,36,28,50,14,9,55
13K553,2007,87,12,5,0,12,0,51,12,1,0,0,46,41,73,14,6,81
13K553,2006,55,9,2,0,11,0,70,16,0,1,0,29,26,45,10,5,50
13K553,2005,64,23,6,0,6,0,52,3,0,0,0,38,26,56,8,8,56
13K553,2004,83,10,1,0,6,0,53,10,1,0,0,51,32,68,15,11,72
13K553,2003,115,11,5,0,5,0,62,21,0,0,0,68,47,95,20,11,104
13K553,2002,128,11,2,0,9,0,116,11,1,0,0,71,57,104,24,9,119
13K553,2001,135,15,0,0,12,0,111,20,4,0,0,76,59,106,29,11,124
13K575,2014,22,10,10,0,8,1,42,9,0,1,0,26,28,20,2,3,19
13K575,2013,54,6,6,0,8,2,35,8,0,0,0,30,23,44,10,6,48
13K575,2012,53,13,13,0,8,0,2,1,0,0,0,36,24,40,13,4,49
13K575,2011,60,11,11,0,3,0,48,5,0,1,0,34,11,53,7,4,56
13K575,2010,45,14,14,0,7,0,50,9,0,1,0,32,13,36,9,1,44
13K575,2009,45,4,4,0,8,0,37,8,0,0,0,57,18,33,12,0,45
13K575,2008,75,6,6,0,25,0,62,9,3,1,0,45,23,66,9,2,73
13K575,2007,68,7,3,0,13,0,57,10,1,0,0,33,19,53,15,1,67
13K575,2006,52,15,8,0,2,0,43,8,0,1,0,30,22,42,10,1,51
13K575,2005,52,19,12,0,4,0,37,14,0,1,0,25,29,45,7,3,49
13K575,2004,54,17,5,0,4,0,46,6,1,1,0,49,23,46,8,2,52
13K575,2003,72,33,13,0,8,0,63,8,0,1,0,41,27,62,10,4,68
13K575,2002,68,19,6,0,12,0,64,4,0,0,0,49,37,47,21,4,64
13K575,2001,86,30,1,0,10,0,78,8,0,0,0,0,3,67,19,7,79
13K594,2017,31,29,29,0,1,1,24,6,0,0,0,16,15,22,9,14,17
13K594,2016,55,47,46,0,5,2,42,11,1,1,0,36,19,46,9,15,40
13K594,2014,21,18,18,0,2,1,51,9,0,0,0,15,6,19,2,3,18
13K594,2013,43,19,19,0,6,1,50,8,0,0,0,22,21,30,13,8,35
13K594,2012,36,19,19,0,4,0,48,6,1,0,0,18,18,18,18,6,30
13K594,2011,75,41,41,0,9,0,2,0,0,0,1,44,31,53,22,15,60
13K594,2010,57,31,31,0,10,0,20,1,0,0,0,37,20,37,20,14,43
13K594,2009,49,29,29,0,3,0,36,6,0,1,0,29,20,49,0,5,44
13K594,2008,61,33,33,0,8,0,31,4,1,0,0,28,33,61,0,14,47
13K594,2007,59,29,29,0,5,0,62,13,0,0,0,39,20,58,1,3,56
13K595,2017,83,81,81,22,0,3,65,9,3,0,4,47,36,61,22,11,72
13K595,2016,84,81,81,28,1,3,56,7,2,1,3,47,37,68,16,4,80
13K595,2015,72,71,71,12,0,1,76,10,3,0,4,43,29,65,7,6,66
13K595,2014,94,92,92,13,1,1,71,4,0,0,7,51,43,67,27,6,88
13K595,2013,83,81,81,1,0,2,81,2,1,0,0,46,37,63,20,8,75
13K595,2012,86,84,84,15,0,5,65,9,0,0,0,43,43,56,30,7,79
13K595,2011,79,76,76,47,0,2,82,5,2,0,0,37,42,52,27,6,73
13K595,2010,91,89,84,50,1,2,96,4,1,1,0,50,41,52,39,5,86
13K595,2009,104,98,97,51,1,2,78,7,0,3,0,58,46,61,43,3,101
13K595,2008,94,91,90,36,0,1,69,7,0,0,0,47,47,51,43,4,90
13K595,2007,90,87,84,34,0,1,83,9,0,1,0,57,33,51,39,3,87
13K595,2006,76,70,65,42,3,0,69,5,3,3,3,41,35,52,24,5,71
13K595,2005,77,73,71,55,0,0,87,6,0,1,0,41,36,51,26,2,75
13K595,2004,117,113,107,68,1,0,69,5,0,1,1,60,57,76,41,4,113
13K595,2003,94,88,85,60,2,0,101,14,0,2,0,50,44,59,35,4,90
13K605,2017,181,163,163,74,1,5,130,40,3,3,0,46,135,155,26,31,150
13K605,2016,172,165,165,32,3,10,114,42,2,0,4,48,124,124,48,28,144
13K605,2015,144,130,111,9,3,5,106,26,5,0,2,39,105,108,36,25,119
13K605,2014,131,88,78,2,10,3,96,26,5,1,0,34,97,107,24,22,109
13K605,2013,112,80,71,5,9,5,79,24,3,1,0,37,75,89,23,17,95
13K605,2012,132,99,81,1,12,3,98,28,2,1,0,39,93,97,35,26,106
13K605,2011,158,101,92,1,7,7,120,26,3,1,1,40,118,132,26,24,134
13K605,2010,196,126,119,12,9,5,163,27,0,1,0,47,149,150,46,28,168
13K605,2009,233,124,117,9,21,8,188,32,3,2,0,68,165,175,58,35,198
13K605,2008,236,116,113,5,21,5,178,50,1,2,0,54,182,179,57,36,200
13K605,2007,146,78,62,3,12,3,110,28,2,3,0,31,115,102,44,31,115
13K605,2006,246,128,68,31,27,4,190,46,2,4,0,86,160,191,55,45,201
13K605,2005,169,101,24,7,15,5,127,34,3,0,0,64,105,116,53,28,141
13K605,2004,241,127,42,12,28,2,185,49,2,3,0,118,123,153,88,48,193
13K605,2003,165,111,42,14,17,3,134,26,2,0,0,67,98,100,65,19,146
13K605,2002,228,130,48,7,32,8,179,40,1,0,0,79,149,128,100,19,209
13K605,2001,175,56,24,2,28,6,122,40,5,2,0,73,102,83,92,44,131
13K616,2017,61,12,10,0,1,1,40,16,2,1,1,24,37,53,8,23,38
13K616,2016,62,13,13,0,15,3,37,20,0,1,1,31,31,46,16,13,49
13K616,2015,62,2,1,0,8,1,65,25,2,0,0,30,32,53,9,12,50
13K616,2014,93,6,5,0,15,1,50,26,1,0,0,55,38,81,12,20,73
13K616,2013,55,5,5,0,12,1,47,16,1,0,0,31,24,47,8,8,47
13K616,2012,78,12,6,0,21,1,38,10,1,0,0,46,32,63,15,16,62
13K616,2011,72,3,2,0,19,0,48,11,1,1,1,34,38,60,12,10,62
13K616,2010,73,3,1,0,15,0,37,17,1,0,0,46,27,61,12,17,56
13K616,2009,77,2,2,0,25,0,57,15,0,0,0,43,34,65,12,6,71
13K616,2008,65,8,6,0,18,0,47,19,5,2,0,33,32,48,17,11,54
13K616,2007,86,7,0,0,21,0,49,28,0,0,0,43,43,71,15,4,82
13K616,2006,88,7,2,0,23,0,65,19,2,0,0,37,51,76,12,7,81
13K616,2005,50,0,0,0,2,0,61,20,5,2,0,22,28,35,15,6,44
13K670,2017,191,183,183,116,5,11,155,20,2,1,2,92,99,118,73,25,166
13K670,2016,156,152,151,44,0,8,123,18,0,2,5,86,70,112,44,22,134
13K670,2015,190,182,179,52,1,8,158,18,4,2,0,105,85,130,60,21,169
13K670,2014,181,172,168,51,1,6,156,15,1,3,0,112,69,123,58,11,170
13K670,2013,241,211,204,42,3,6,212,14,2,7,0,129,112,165,76,15,226
13K670,2012,225,212,208,31,3,5,199,17,1,1,2,127,98,99,126,8,217
13K670,2011,215,196,193,65,4,11,178,23,1,2,0,118,97,104,111,5,210
13K670,2010,194,176,173,51,1,3,172,16,0,3,0,105,89,105,89,7,187
13K670,2009,223,208,208,39,2,6,198,18,1,0,0,117,106,140,83,6,217
13K670,2008,201,187,185,52,3,4,180,14,2,1,0,128,73,117,84,8,193
13K670,2007,162,146,142,78,0,4,143,13,1,0,1,93,69,96,66,5,157
13K670,2006,234,216,206,101,6,4,195,29,1,4,1,139,95,159,75,17,217
13K670,2005,246,234,230,133,3,9,195,33,5,1,3,160,86,155,91,6,240
13K670,2004,238,218,209,135,7,8,190,29,6,1,4,143,95,154,84,3,235
13K670,2003,200,181,160,72,5,3,167,21,0,1,8,116,84,125,75,5,195
13K670,2002,155,137,128,45,5,3,131,18,2,0,1,85,70,76,79,6,149
13K670,2001,141,128,97,1,2,2,126,11,2,0,0,86,55,65,76,4,137
13K674,2017,80,76,76,0,0,4,56,12,6,0,2,12,68,57,23,16,64
13K674,2016,80,72,72,0,2,8,50,17,5,0,0,13,67,63,17,12,68
13K674,2015,83,68,62,0,4,5,68,7,3,0,0,13,70,61,22,12,71
13K674,2014,110,84,77,0,3,5,82,17,2,4,0,33,77,81,29,20,90
13K674,2013,109,90,79,0,1,3,79,24,1,2,0,34,75,73,36,23,86
13K674,2012,107,87,79,0,3,3,85,14,3,2,0,29,78,70,37,15,92
13K674,2011,114,98,95,0,1,11,66,29,7,1,0,23,91,74,40,18,96
13K674,2010,155,72,65,2,3,14,95,40,6,0,0,26,129,102,53,25,130
13K674,2009,63,43,41,2,0,6,40,14,3,0,0,18,45,43,20,3,60
14K071,2017,64,29,29,4,8,2,8,49,4,0,1,27,37,51,13,15,49
14K071,2016,80,53,51,2,8,1,12,64,3,0,0,38,42,70,10,22,58
14K071,2015,97,54,45,1,14,2,14,75,5,0,1,39,58,75,22,30,67
14K071,2014,77,50,40,1,9,2,10,83,1,0,0,38,39,60,17,22,55
14K071,2013,97,63,51,2,10,1,13,59,2,0,0,44,53,75,22,20,77
14K071,2012,113,51,42,0,22,0,7,70,0,0,0,54,59,77,36,41,72
14K071,2011,85,36,32,0,17,0,14,78,3,2,0,34,51,72,13,24,61
14K071,2010,96,52,50,0,18,0,18,89,3,2,1,46,50,74,22,16,80
14K071,2009,108,49,44,2,15,0,12,73,0,0,0,56,52,108,0,22,86
14K071,2008,111,43,38,0,15,0,13,90,5,0,0,42,69,111,0,32,79
14K071,2007,99,40,31,0,9,0,21,89,1,0,0,61,38,98,1,18,81
14K071,2006,100,40,27,0,18,0,18,78,3,0,0,50,50,98,2,21,79
14K071,2005,94,46,34,3,7,0,12,85,3,0,0,45,49,94,0,15,79
14K071,2004,75,46,26,0,6,0,18,75,1,0,0,40,35,73,2,18,57
14K322,2012,26,13,8,0,8,0,4,1,0,0,0,11,15,22,4,11,15
14K322,2011,36,12,8,0,10,0,15,11,0,0,0,21,15,27,9,6,30
14K322,2010,23,3,2,0,7,0,13,8,1,0,1,13,10,21,2,5,18
14K322,2009,27,2,2,0,6,0,18,9,0,0,0,11,16,27,0,7,20
14K322,2008,47,9,8,1,11,0,29,18,0,0,0,20,27,35,12,19,28
14K322,2007,73,34,31,1,17,0,60,10,1,2,0,36,37,52,21,13,60
14K322,2006,60,41,26,1,2,0,54,6,0,0,0,35,25,51,9,9,51
14K322,2005,94,71,53,1,1,0,79,15,0,0,0,52,42,79,15,7,87
14K449,2017,162,158,158,127,2,99,19,13,20,0,11,72,90,114,48,5,157
14K449,2016,155,150,150,126,2,84,20,16,20,1,14,72,83,81,74,8,147
14K449,2015,156,152,152,101,0,72,23,24,28,0,9,68,88,91,65,3,153
14K449,2014,194,187,187,112,1,89,20,21,25,0,39,91,103,123,71,2,192
14K449,2013,173,171,171,74,0,70,35,30,13,1,24,80,93,124,49,5,168
14K449,2012,116,109,109,35,1,34,30,15,14,0,23,53,63,74,42,1,115
14K449,2011,158,153,153,56,0,51,37,24,31,2,13,68,90,121,37,3,155
14K449,2010,111,107,107,15,0,53,29,19,10,0,0,55,56,79,32,0,111
14K449,2009,86,82,82,13,0,30,23,16,15,2,0,46,40,55,31,1,85
14K449,2008,70,68,68,18,1,21,24,18,6,1,0,30,40,44,26,2,68
14K449,2007,35,32,32,28,0,16,6,8,5,0,0,15,20,23,12,0,35
14K449,2006,51,47,47,26,0,4,21,19,5,2,0,30,21,30,21,0,51
14K454,2017,76,70,69,0,3,4,14,56,1,0,1,40,36,63,13,17,59
14K454,2016,52,44,36,1,2,2,14,32,3,1,0,30,22,40,12,13,39
14K454,2015,71,57,36,0,10,1,36,57,0,0,1,27,44,52,19,19,52
14K454,2014,41,34,23,0,2,1,43,50,1,0,0,16,25,32,9,11,30
14K454,2013,56,34,24,0,12,3,39,35,1,0,0,28,28,48,8,15,41
14K454,2012,56,39,35,0,11,2,49,36,3,1,0,26,30,42,14,13,43
14K454,2011,95,61,61,0,19,0,17,51,2,0,1,53,42,75,20,18,77
14K454,2010,95,44,39,0,20,0,17,22,1,0,1,53,42,76,19,18,77
14K454,2009,78,34,30,0,14,0,16,38,2,0,0,39,39,56,22,11,67
14K454,2008,91,61,57,0,13,0,21,35,0,0,0,49,42,71,20,14,77
14K454,2007,86,44,34,0,15,0,33,51,1,1,0,39,47,68,18,15,71
14K454,2006,96,52,45,0,15,0,36,58,1,1,0,48,48,79,17,8,88
14K474,2017,166,106,102,18,19,2,34,125,2,1,2,82,84,146,20,37,129
14K474,2016,172,110,109,8,16,1,45,119,3,0,4,80,92,152,20,30,142
14K474,2015,222,153,123,0,18,1,78,136,1,2,4,100,122,176,46,44,178
14K474,2014,215,152,138,2,20,2,67,141,1,0,0,100,115,185,30,37,178
14K474,2013,211,142,125,2,25,6,91,185,1,0,0,95,116,176,35,44,167
14K474,2012,283,184,170,2,27,1,93,189,3,0,0,127,156,225,58,44,239
14K474,2011,286,190,183,0,33,1,82,174,2,1,0,147,139,232,54,43,243
14K474,2010,260,133,127,2,33,3,85,159,1,0,0,123,137,223,37,42,218
14K474,2009,248,126,122,5,40,3,68,152,3,1,0,134,114,204,44,31,217
14K474,2008,227,146,139,6,19,2,66,143,2,2,0,115,112,190,37,24,203
14K474,2007,215,119,83,9,38,1,71,132,1,2,0,130,85,184,31,24,191
14K474,2006,207,133,99,5,13,1,75,139,3,2,0,102,105,173,34,18,189
14K474,2005,220,142,82,3,23,1,100,162,6,1,0,126,94,180,40,19,201
14K474,2004,270,133,75,5,25,7,68,158,6,0,0,156,114,193,77,35,235
14K474,2003,239,128,78,4,27,2,59,148,4,0,0,138,101,161,78,20,219
14K474,2002,213,114,25,1,20,1,23,102,2,0,0,116,97,132,81,21,192
14K474,2001,128,71,32,0,12,0,72,135,6,2,0,55,73,63,65,25,103
14K477,2017,51,37,37,17,6,2,39,64,1,0,4,28,23,48,3,7,44
14K477,2016,86,53,53,11,6,1,53,83,2,0,1,43,43,82,4,17,69
14K477,2015,84,62,24,0,6,1,72,79,3,0,3,41,43,80,4,18,66
14K477,2014,110,61,41,1,16,2,70,93,3,0,2,49,61,98,12,24,86
14K477,2013,140,75,69,2,17,1,98,79,2,0,0,69,71,121,19,21,119
14K477,2012,158,89,81,5,27,2,107,90,3,1,0,73,85,126,32,34,124
14K477,2011,170,73,65,2,40,2,138,61,6,0,8,93,77,148,22,21,149
14K477,2010,180,85,79,4,34,1,110,61,1,0,0,89,91,159,21,26,154
14K477,2009,203,82,81,0,35,3,98,77,2,0,0,110,93,162,41,20,183
14K477,2008,215,144,139,8,20,1,121,61,6,1,0,125,90,175,40,29,186
14K477,2007,173,112,78,2,33,4,51,51,5,0,0,95,78,171,2,24,149
14K477,2006,146,86,47,1,24,0,24,25,2,0,0,78,68,142,4,15,131
14K477,2005,162,99,49,5,19,0,30,55,1,0,0,80,82,156,6,12,150
14K477,2004,168,96,24,2,24,0,33,50,0,0,1,93,75,123,45,32,136
14K477,2003,180,95,53,5,20,0,99,47,0,0,0,94,86,131,49,27,153
14K477,2002,190,120,81,11,16,0,90,70,2,0,0,118,72,117,73,13,177
14K477,2001,111,66,37,2,17,0,91,76,1,0,0,47,64,74,37,15,96
14K478,2017,203,160,160,81,15,13,61,123,3,3,0,81,122,180,23,33,170
14K478,2016,217,174,171,37,9,13,63,139,2,0,0,82,135,196,21,32,185
14K478,2015,179,132,112,7,17,4,60,112,2,1,0,61,118,152,27,30,149
14K478,2014,215,160,131,8,18,5,69,132,6,3,0,71,144,168,47,47,168
14K478,2013,224,155,140,1,15,8,77,133,4,1,1,83,141,160,64,37,187
14K478,2012,233,183,169,12,15,13,92,122,5,1,0,78,155,181,52,45,188
14K478,2011,266,181,177,7,27,12,105,142,7,0,0,88,178,225,41,33,233
14K478,2010,250,163,153,14,15,7,98,141,4,0,0,92,158,213,37,37,213
14K478,2009,217,135,127,11,17,6,81,123,6,1,0,72,145,187,30,28,189
14K478,2008,234,158,147,20,16,7,94,128,5,0,0,77,157,146,88,32,202
14K478,2007,214,171,154,15,4,3,86,119,2,4,0,68,146,147,67,18,196
14K478,2006,161,134,103,6,5,4,66,87,2,2,0,50,111,135,26,23,138
14K478,2005,168,144,107,73,2,4,53,105,5,1,0,71,97,122,46,13,155
14K478,2004,171,153,116,80,3,1,50,118,2,0,0,79,92,114,57,22,149
14K478,2003,174,136,91,47,20,2,48,120,4,0,0,75,99,126,48,15,159
14K478,2002,170,112,49,8,21,1,46,123,0,0,0,79,91,119,51,13,157
14K478,2001,139,99,52,4,15,3,41,93,2,0,0,55,84,95,44,19,120
14K488,2017,108,97,95,0,0,1,34,68,4,0,1,59,49,88,20,28,80
14K488,2016,136,117,113,0,1,4,63,65,1,2,1,89,47,120,16,19,117
14K488,2015,138,127,115,0,1,3,62,68,2,2,1,65,73,108,30,25,113
14K488,2014,119,109,101,0,2,2,63,50,2,2,0,63,56,97,22,20,99
14K488,2013,118,106,95,0,4,4,76,36,1,0,1,63,55,86,32,19,99
14K488,2012,121,104,95,0,3,2,69,48,2,0,0,72,49,95,26,15,106
14K488,2011,108,94,78,0,6,4,52,48,4,0,0,56,52,91,17,21,87
14K488,2010,115,90,66,1,4,4,67,27,1,1,0,60,55,93,22,22,93
14K488,2009,100,69,50,0,7,1,49,17,1,1,0,52,48,79,21,15,85
14K488,2008,69,49,41,1,5,1,53,24,3,0,0,33,36,61,8,19,50
14K488,2007,81,58,54,1,5,1,64,10,0,0,0,41,40,73,8,11,70
14K488,2006,75,59,46,1,5,2,47,5,1,0,0,43,32,59,16,15,60
14K488,2005,84,65,48,3,1,0,60,53,1,1,0,57,27,69,15,7,77
14K488,2004,55,53,47,4,1,0,64,16,2,1,1,34,21,39,16,5,50
14K558,2017,147,144,144,61,0,3,34,97,11,2,0,33,114,121,26,33,114
14K558,2016,126,121,120,36,2,1,47,68,7,0,3,21,105,96,30,31,95
14K558,2015,124,120,120,12,1,6,35,72,9,1,1,37,87,101,23,26,98
14K558,2014,131,128,120,49,2,4,35,84,6,0,2,30,101,114,17,33,98
14K558,2013,130,124,120,33,2,3,41,80,5,1,0,28,102,111,19,38,92
14K558,2012,136,128,124,34,6,5,42,84,3,2,0,32,104,105,31,34,102
14K558,2011,148,138,132,29,4,3,52,84,6,1,2,30,118,114,34,41,107
14K558,2010,116,105,101,27,8,1,44,69,2,0,0,44,72,87,29,31,85
14K558,2009,92,83,81,25,6,1,38,52,1,0,0,28,64,82,10,12,80
14K558,2008,102,89,81,19,6,2,39,58,3,0,0,29,73,88,14,18,84
14K558,2007,102,89,82,7,7,3,44,49,6,0,0,22,80,90,12,15,87
14K558,2006,97,80,70,4,7,1,64,26,6,0,0,16,81,86,11,12,85
14K558,2005,80,61,54,3,7,7,40,26,1,0,2,27,53,62,18,6,74
14K558,2004,76,56,38,6,9,0,47,24,8,1,0,15,61,74,2,13,63
14K561,2017,171,168,168,42,0,5,30,118,14,1,3,91,80,134,37,29,142
14K561,2016,156,151,141,51,0,8,27,96,19,0,1,76,80,124,32,30,126
14K561,2015,151,143,132,27,1,7,27,103,17,3,0,77,74,118,33,29,122
14K561,2014,157,149,142,31,2,3,33,118,13,0,1,68,89,119,38,19,138
14K561,2013,168,158,150,43,1,7,23,131,19,1,0,84,84,133,35,20,148
14K561,2012,181,160,146,39,4,2,39,104,22,2,2,96,85,138,43,32,149
14K561,2011,171,154,144,46,7,3,50,96,16,0,1,89,82,134,37,19,152
14K561,2010,166,145,135,16,6,2,41,86,11,0,0,83,83,134,32,20,146
14K561,2009,140,119,118,20,6,3,42,60,13,1,0,73,67,113,27,7,133
14K561,2008,119,106,104,24,4,1,40,58,12,0,0,51,68,119,0,17,102
14K561,2007,111,97,90,13,2,3,31,59,14,1,0,62,49,111,0,12,99
14K561,2006,108,93,88,12,8,2,28,44,12,1,1,59,49,108,0,18,90
14K561,2005,103,88,83,23,5,0,19,119,18,0,0,59,44,103,0,4,99
14K561,2004,88,66,62,15,6,0,45,53,4,0,1,51,37,87,1,7,81
14K586,2017,68,54,54,0,9,3,28,58,3,0,1,38,30,62,6,14,54
14K586,2016,73,53,53,0,4,1,27,50,3,0,0,35,38,65,8,22,51
14K586,2015,76,55,55,0,4,1,27,41,0,0,0,39,37,70,6,16,60
14K586,2014,93,64,58,0,13,2,37,38,2,0,0,32,61,80,13,20,73
14K586,2013,81,52,43,0,11,0,15,49,4,0,0,38,43,71,10,16,65
14K586,2012,76,49,43,0,11,0,29,43,1,0,0,43,33,60,16,11,65
14K586,2011,69,43,34,0,9,0,24,50,2,0,0,33,36,55,14,22,47
14K586,2010,79,36,35,0,10,0,39,37,0,0,0,40,39,62,17,15,64
14K586,2009,73,37,34,0,9,0,41,28,2,2,0,38,35,53,20,15,58
14K586,2008,73,38,38,0,16,0,20,51,2,0,0,39,34,63,10,11,62
14K586,2007,91,55,36,0,12,0,40,48,2,1,0,44,47,65,26,15,76
14K610,2017,76,60,60,28,9,1,35,32,5,1,2,9,67,67,9,29,47
14K610,2016,86,64,64,18,11,3,39,38,2,2,2,7,79,73,13,33,53
14K610,2015,79,56,42,0,9,3,45,27,3,1,0,8,71,62,17,27,52
14K610,2014,116,88,67,2,12,2,67,42,1,0,4,13,103,92,24,33,83
14K610,2013,42,31,24,1,5,1,16,24,0,1,0,5,37,35,7,15,27
14K610,2012,100,57,40,0,15,2,55,38,5,0,0,3,97,70,30,38,62
14K610,2011,96,44,38,0,24,1,60,31,4,0,0,3,93,69,27,33,63
14K610,2010,130,64,43,0,34,2,86,40,1,1,0,8,122,98,32,44,86
14K610,2009,187,79,67,1,35,5,116,63,2,1,0,6,181,141,46,44,143
14K610,2008,176,104,103,0,31,1,123,46,5,1,0,12,164,107,69,32,144
14K610,2007,241,119,70,1,53,3,165,65,8,0,0,14,227,147,94,54,187
14K610,2006,233,127,55,0,33,5,142,78,5,2,1,15,218,147,86,51,182
14K610,2005,215,115,51,0,26,3,114,92,4,2,0,11,204,137,78,40,175
14K610,2004,185,96,40,34,31,2,95,83,3,2,0,16,169,133,52,37,148
14K610,2003,134,62,16,12,23,3,69,59,2,0,1,14,120,84,50,34,100
14K610,2002,103,42,10,0,25,1,59,40,3,0,0,10,93,79,24,24,79
14K610,2001,95,35,12,0,24,0,61,27,6,1,0,7,88,83,12,33,62
14K614,2017,57,55,55,26,1,1,29,23,3,0,1,57,0,44,13,6,51
14K614,2016,46,41,41,16,2,1,16,24,5,0,0,46,0,37,9,6,40
14K614,2015,31,30,28,8,1,1,17,9,2,0,2,31,0,20,11,3,28
14K614,2014,68,65,57,1,1,2,46,16,1,1,2,68,0,48,20,15,53
14K614,2013,52,52,47,9,0,4,30,15,1,0,2,52,0,37,15,6,46
14K614,2012,63,63,58,0,0,2,46,11,0,0,4,63,0,36,27,8,55
14K614,2011,45,45,41,0,0,1,26,16,1,1,0,45,0,34,11,7,38
14K632,2013,29,21,17,0,2,0,1,0,0,0,0,9,20,26,3,9,20
14K632,2012,22,14,10,1,2,0,21,5,2,1,0,8,14,20,2,7,15
14K632,2011,41,26,22,0,4,0,27,12,1,1,0,14,27,37,4,10,31
14K632,2010,34,17,12,0,3,0,22,11,1,0,0,9,25,29,5,8,26
14K632,2009,37,15,12,0,2,0,24,12,1,0,0,8,29,35,2,9,28
14K632,2008,56,29,28,0,5,0,30,22,4,0,0,12,44,51,5,14,42
14K640,2003,156,87,18,2,37,4,156,110,5,0,0,90,107,140,16,53,222
14K640,2002,197,94,21,2,48,0,2,2,0,0,0,124,151,106,91,2,0
14K640,2001,275,104,29,4,92,0,0,2,0,0,0,0,4,199,76,4,0
14K685,2017,47,34,34,0,1,1,2,50,0,2,1,25,22,44,3,9,38
14K685,2016,49,29,29,0,2,1,8,47,0,0,0,20,29,45,4,12,37
14K685,2015,56,44,44,0,2,1,4,40,2,0,0,30,26,46,10,14,42
14K685,2014,53,42,42,0,2,2,6,41,0,0,0,34,19,45,8,14,39
14K685,2013,57,32,32,0,4,1,6,34,0,0,0,34,23,43,14,15,42
14K685,2012,66,51,51,0,3,0,3,44,0,0,0,30,36,50,16,17,49
14K685,2011,56,37,37,0,6,0,1,48,0,0,0,33,23,48,8,8,48
14K685,2010,47,30,30,0,9,0,6,43,1,0,3,23,24,37,10,10,37
14K685,2009,49,38,37,0,4,0,7,48,1,0,1,29,20,34,15,12,37
14K685,2008,47,32,32,0,5,0,6,58,2,0,0,30,17,39,8,11,36
14K685,2007,45,30,29,0,3,0,4,43,0,0,0,18,27,33,12,10,35
14K685,2006,41,28,26,0,1,0,6,39,0,0,0,25,16,35,6,11,30
14K685,2005,31,23,0,0,1,0,6,25,0,0,0,23,8,28,3,2,29
14K685,2004,30,25,0,0,0,0,4,25,1,0,0,16,14,27,3,6,24
14K685,2003,26,15,0,0,0,0,1,25,0,0,0,12,14,13,13,8,18
14K685,2002,41,24,0,0,2,0,4,37,0,0,0,23,18,30,11,7,34
14K685,2001,32,17,0,0,1,0,3,26,3,0,0,18,14,22,10,7,25
15K027,2007,7,0,0,0,5,0,3,3,1,0,0,3,0,3,4,1,2
15K423,2017,77,27,26,0,13,4,44,27,2,0,0,31,46,56,21,33,44
15K423,2016,105,28,24,0,17,2,63,36,2,1,1,50,55,94,11,41,64
15K423,2015,101,15,10,0,43,3,71,24,2,1,0,38,63,89,12,46,55
15K423,2014,76,11,10,0,21,1,56,15,3,1,0,37,39,68,8,30,46
15K423,2013,42,17,12,0,13,1,37,15,0,0,0,22,20,38,4,20,22
15K423,2012,53,9,6,0,25,0,31,11,0,0,0,27,26,41,12,33,20
15K423,2011,68,20,17,0,25,0,48,19,1,0,0,39,29,61,7,21,47
15K429,2017,72,70,70,11,1,1,21,11,0,0,0,30,42,61,11,18,54
15K429,2016,33,32,32,1,0,4,25,13,1,0,0,17,16,32,1,4,29
15K429,2015,43,42,33,1,0,1,15,17,1,0,0,18,25,34,9,10,33
15K429,2014,26,24,17,0,1,2,21,16,4,0,0,11,15,21,5,6,20
15K429,2013,34,24,21,2,6,1,20,10,2,0,1,17,17,30,4,8,26
15K429,2012,43,33,29,0,7,1,22,22,4,0,0,12,31,34,9,14,29
15K429,2011,34,22,20,0,4,2,40,29,1,0,0,13,21,26,8,8,26
15K429,2010,49,25,23,0,10,3,43,31,3,1,0,22,27,40,9,14,35
15K429,2009,72,49,49,0,6,1,40,32,3,0,0,34,38,57,15,14,58
15K429,2008,81,49,48,0,11,1,50,37,3,0,0,43,38,67,14,20,61
15K429,2007,76,41,39,0,8,1,35,45,12,0,0,39,37,59,17,11,65
15K429,2006,91,48,46,0,3,1,42,26,4,0,1,47,44,57,34,13,78
15K429,2005,107,45,32,0,6,1,35,34,13,1,0,53,54,80,27,29,78
15K429,2004,93,41,23,0,10,2,32,42,6,2,0,55,38,60,33,25,68
15K429,2003,74,32,1,0,4,0,38,27,3,1,3,31,43,45,29,14,60
15K429,2002,84,45,0,0,14,0,18,6,2,0,0,51,33,42,42,14,70
15K429,2001,84,33,0,0,20,0,66,34,6,1,0,42,42,40,44,15,69
15K448,2017,94,85,85,0,0,6,39,35,11,1,2,51,43,76,18,26,68
15K448,2016,86,76,76,0,4,2,29,51,4,0,0,44,42,65,21,21,65
15K448,2015,95,84,84,0,6,2,39,42,11,1,0,50,45,69,26,26,69
15K448,2014,91,70,70,0,7,3,38,37,10,2,1,44,47,66,25,26,65
15K448,2013,88,80,80,0,2,5,31,42,9,0,1,41,47,66,22,25,63
15K448,2012,97,86,85,0,4,9,44,36,8,0,0,58,39,67,30,27,70
15K448,2011,88,77,77,0,2,7,31,41,9,0,0,35,53,52,36,25,63
15K448,2010,92,82,81,0,4,4,37,39,11,1,0,35,57,58,34,22,70
15K448,2009,84,72,70,0,4,7,33,32,12,0,0,50,34,66,18,22,62
15K448,2008,94,78,78,0,10,1,30,53,10,0,0,41,53,71,23,23,71
15K448,2007,77,70,67,0,4,2,29,43,3,0,0,40,37,57,20,25,52
15K448,2006,76,64,62,0,3,1,38,33,4,0,0,45,31,56,20,27,49
15K448,2005,79,69,52,0,3,4,37,27,11,0,0,43,36,39,40,11,68
15K460,2001,27,1,0,0,18,0,0,1,1,0,0,0,2,17,10,26,1
15K462,2017,111,94,94,27,4,2,78,26,4,0,1,57,54,89,22,16,95
15K462,2016,89,77,76,21,6,3,48,20,2,0,2,63,26,75,14,10,79
15K462,2015,75,64,54,4,3,1,50,23,1,0,4,44,31,63,12,11,64
15K462,2014,79,62,54,3,8,3,63,15,5,1,2,52,27,63,16,11,68
15K462,2013,89,71,67,4,7,2,44,11,4,1,2,59,30,71,18,8,81
15K462,2012,64,51,43,2,3,2,49,28,4,0,0,44,20,55,9,13,51
15K462,2011,83,73,67,6,3,3,69,23,7,0,1,43,40,65,18,10,73
15K462,2010,103,80,75,2,5,2,64,26,3,0,0,60,43,88,15,12,91
15K462,2009,95,73,61,7,7,3,63,24,5,0,0,50,45,76,19,13,82
15K462,2008,95,73,63,4,1,2,66,31,4,0,0,60,35,79,16,14,81
15K462,2007,103,74,66,5,8,2,61,20,5,1,0,74,29,87,16,15,88
15K462,2006,89,55,35,3,4,4,44,28,7,0,0,53,36,62,27,10,79
15K462,2005,83,58,45,11,2,3,58,11,7,1,0,51,32,66,17,3,80
15K462,2004,80,54,37,4,4,3,33,20,1,0,0,46,34,59,21,1,79
15K462,2003,57,34,19,3,11,3,90,21,8,0,0,40,17,36,21,4,53
15K462,2002,41,17,6,1,5,0,61,22,5,1,0,26,15,26,15,7,34
15K462,2001,122,69,0,0,8,0,15,20,6,0,0,85,37,77,45,4,118
15K463,2017,50,34,34,0,5,1,21,26,2,0,0,22,28,36,14,7,43
15K463,2016,58,41,41,0,9,7,23,21,7,0,0,30,28,46,12,10,48
15K463,2015,58,30,29,0,11,3,34,19,2,0,0,36,22,50,8,12,46
15K463,2014,60,36,28,0,5,3,28,18,9,0,2,41,19,55,5,10,50
15K463,2013,52,32,26,5,4,3,25,21,2,1,0,37,15,44,8,7,45
15K463,2012,43,30,27,2,4,5,22,11,4,0,1,24,19,33,10,5,38
15K463,2011,80,45,40,5,10,7,35,32,6,0,0,43,37,62,18,11,69
15K463,2010,65,38,38,0,4,10,23,28,4,0,0,38,27,59,6,13,52
15K463,2009,70,41,39,0,6,6,32,27,4,1,0,42,28,54,16,11,59
15K463,2008,71,39,38,0,10,5,37,28,1,0,0,41,30,57,14,10,61
15K463,2007,101,57,43,6,12,7,44,46,4,0,0,52,49,71,30,18,83
15K463,2006,94,51,29,2,7,3,55,32,4,0,0,63,31,67,27,11,83
15K463,2005,88,48,28,7,6,5,54,21,7,0,1,60,28,56,32,7,81
15K463,2004,92,59,40,12,1,2,56,31,3,0,0,66,26,66,26,7,85
15K463,2003,54,31,25,2,1,1,26,25,2,0,0,38,16,37,17,12,42
15K463,2002,43,22,17,1,5,4,20,15,2,2,0,30,13,26,17,3,40
15K464,2017,82,64,64,0,3,2,37,30,9,1,3,39,43,64,18,17,65
15K464,2016,103,83,82,5,1,5,33,49,14,0,2,47,56,78,25,21,82
15K464,2015,98,82,66,2,4,3,44,43,6,0,2,35,63,75,23,16,82
15K464,2014,78,59,49,0,4,6,30,33,5,1,3,36,42,63,15,12,66
15K464,2013,70,44,38,0,6,5,30,27,2,1,5,32,38,53,17,16,54
15K464,2012,79,62,56,0,3,6,45,18,3,0,7,35,44,62,17,14,65
15K464,2011,51,33,28,0,5,6,18,24,2,0,1,24,27,40,11,8,43
15K464,2010,62,36,34,4,6,5,19,34,3,1,0,22,40,49,13,9,53
15K464,2009,59,21,20,1,8,4,15,32,8,0,0,29,30,50,9,6,53
15K464,2008,103,61,58,6,11,8,30,59,5,1,0,50,53,88,15,14,89
15K464,2007,84,45,36,4,6,3,36,38,7,0,0,44,40,68,16,8,76
15K464,2006,87,51,31,5,6,8,42,34,2,0,1,52,35,65,22,13,74
15K464,2005,84,57,33,8,3,5,38,38,3,0,0,45,39,56,28,12,72
15K464,2004,81,61,35,4,4,11,33,30,6,1,0,41,40,59,22,9,72
15K464,2003,48,32,20,3,1,9,17,14,6,0,2,23,25,32,16,3,45
15K464,2002,35,14,8,0,2,4,8,20,3,0,0,13,22,18,17,4,31
15K464,2001,48,19,6,0,3,7,6,30,5,0,0,29,19,31,17,9,39
15K497,2017,52,44,44,7,1,1,23,19,6,0,3,28,24,37,15,14,38
15K497,2016,54,48,48,0,0,5,24,14,4,1,6,32,22,35,19,8,46
15K497,2015,51,37,36,0,0,2,28,12,9,0,0,26,25,33,18,10,41
15K497,2014,64,34,34,0,3,2,33,22,6,1,0,32,32,54,10,11,53
15K497,2013,76,57,51,0,3,3,38,27,6,0,2,39,37,61,15,8,68
15K497,2012,61,41,37,0,6,3,23,24,11,0,0,32,29,37,24,8,53
15K497,2011,62,41,41,4,5,3,25,25,7,0,2,39,23,39,23,5,57
15K497,2010,89,55,51,0,7,5,38,33,13,0,0,43,46,70,19,10,79
15K497,2009,74,33,33,0,11,4,26,31,13,0,0,37,37,56,18,11,63
15K497,2008,86,57,54,4,6,2,38,34,12,0,0,40,46,68,18,13,73
15K497,2007,87,48,43,8,8,2,43,31,11,0,0,47,40,58,29,17,70
15K497,2006,65,41,28,1,7,4,21,25,15,0,0,30,35,43,22,8,57
15K497,2005,68,43,32,5,9,1,36,20,10,0,1,40,28,44,24,10,58
15K497,2004,68,43,28,5,10,3,36,24,5,0,0,33,35,35,33,11,57
15K497,2003,59,39,10,2,4,1,31,21,6,0,0,24,35,41,18,12,47
15K497,2002,65,36,7,1,10,5,21,30,9,0,0,29,36,36,29,9,56
15K497,2001,86,34,9,0,14,2,44,34,6,0,0,46,40,44,42,9,77
15K519,2017,120,99,99,22,3,10,63,39,4,0,4,64,56,94,26,24,96
15K519,2016,118,81,76,4,1,3,73,37,1,1,3,57,61,95,23,15,103
15K519,2015,145,123,94,3,6,3,101,33,3,2,3,80,65,134,11,26,119
15K519,2014,137,119,104,4,2,2,85,41,4,2,3,73,64,127,10,25,112
15K519,2013,108,80,66,1,3,2,62,28,9,2,5,53,55,94,14,28,80
15K519,2012,129,102,80,1,1,8,78,34,9,0,0,58,71,109,20,34,95
15K519,2011,140,109,87,5,9,8,102,26,3,1,0,59,81,118,22,27,113
15K519,2010,120,83,63,5,14,6,85,26,3,0,0,71,49,101,19,33,87
15K519,2009,146,112,93,10,16,4,113,26,2,1,0,97,49,125,21,23,123
15K519,2008,175,117,100,17,18,8,121,43,3,0,0,98,77,149,26,33,142
15K519,2007,144,77,54,0,32,4,103,35,0,0,2,79,65,105,39,34,110
15K519,2006,142,90,49,0,20,3,107,28,3,0,1,76,66,98,44,27,115
15K519,2005,155,97,46,3,14,3,101,48,2,1,0,73,82,101,54,39,116
15K519,2004,200,84,39,6,18,6,123,67,4,0,0,101,99,156,44,43,157
15K519,2003,154,68,46,12,16,2,92,53,7,0,0,76,78,102,52,23,131
15K519,2002,198,96,55,0,29,3,102,84,8,1,0,114,84,114,84,27,171
15K519,2001,205,89,32,3,43,5,99,85,15,1,0,96,109,125,80,24,181
15K520,2008,25,11,5,0,12,3,59,9,1,1,1,10,15,17,8,3,22
15K520,2007,95,14,5,0,13,0,22,3,0,0,0,53,42,65,30,4,91
15K520,2006,71,9,4,0,9,0,77,17,1,0,0,25,46,55,16,11,60
15K520,2005,69,7,3,0,14,0,56,15,0,0,0,40,29,50,19,6,63
15K520,2004,74,6,3,0,12,0,59,8,1,1,0,40,34,56,18,8,66
15K520,2003,93,10,2,0,4,0,78,14,0,0,1,46,47,72,21,8,85
15K520,2002,153,9,4,0,9,0,125,26,2,0,0,72,81,118,35,10,143
15K520,2001,128,10,0,0,5,0,112,14,2,0,0,62,66,86,42,8,120
15K529,2017,62,6,6,0,5,3,4,40,14,0,1,30,32,52,10,24,38
15K529,2016,108,3,3,0,6,7,14,69,15,2,1,37,71,86,22,54,54
15K529,2015,89,4,2,0,13,7,12,57,13,0,0,36,53,69,20,28,61
15K529,2014,96,4,4,0,16,6,15,63,12,0,0,37,59,72,24,35,61
15K529,2013,97,9,7,0,14,9,12,68,7,1,0,41,56,74,23,34,63
15K529,2012,81,9,7,0,17,6,5,52,17,0,1,40,41,58,23,22,59
15K529,2011,66,9,6,0,12,9,8,41,8,0,0,29,37,57,9,11,55
15K529,2010,81,8,8,0,13,5,12,47,17,0,0,37,44,58,23,15,66
15K529,2009,119,8,4,0,19,8,16,74,21,0,0,45,74,90,29,19,100
15K529,2008,85,3,3,0,18,11,5,51,18,0,0,36,49,66,19,10,75
15K529,2007,101,14,7,0,21,11,8,69,13,0,0,39,62,75,26,6,95
15K529,2006,107,11,8,0,10,10,15,66,16,0,0,43,64,69,38,10,97
15K529,2005,96,21,12,0,15,11,20,43,20,1,1,43,53,64,32,6,90
15K529,2004,97,16,10,0,13,2,23,52,20,0,0,43,54,70,27,3,94
15K529,2003,62,4,1,0,3,1,5,14,1,0,0,43,19,47,15,2,60
15K529,2002,21,0,0,0,0,0,15,40,7,0,0,10,11,15,6,3,18
15K530,2010,9,5,4,0,3,3,95,18,2,1,0,4,5,8,1,2,7
15K530,2009,49,19,16,0,8,1,67,13,2,1,0,27,22,49,0,11,38
15K530,2008,87,35,31,0,23,1,70,10,1,2,0,45,42,87,0,17,70
15K530,2007,119,67,51,0,18,1,53,12,1,0,0,54,65,119,0,17,102
15K530,2006,84,35,14,0,12,1,62,8,2,0,0,44,40,84,0,13,71
15K530,2005,84,38,22,2,11,1,62,27,1,0,0,46,38,82,2,19,65
15K530,2004,67,34,20,1,6,0,7,2,0,0,0,34,33,67,0,4,63
15K530,2003,86,44,0,0,3,0,37,11,0,1,0,46,40,76,10,9,77
15K530,2002,73,43,12,0,5,0,70,15,2,0,0,42,31,72,1,5,68
15K530,2001,91,61,2,0,7,0,78,8,0,0,0,52,39,88,3,5,86
15K592,2017,53,41,41,3,5,11,18,12,10,0,2,24,29,46,7,12,41
15K592,2016,49,38,38,7,5,6,20,6,15,1,1,20,29,44,5,8,41
15K592,2015,67,34,30,4,4,7,23,2,28,2,5,31,36,58,9,13,54
15K592,2014,72,54,51,2,6,18,28,5,18,1,2,36,36,62,10,13,59
15K592,2013,51,32,29,5,7,10,21,2,18,0,0,18,33,24,27,7,44
15K592,2012,52,35,31,0,9,4,29,2,15,2,0,25,27,29,23,7,45
15K656,2017,217,181,181,65,2,8,144,53,6,1,5,168,49,171,46,41,176
15K656,2016,199,176,176,86,4,4,147,38,7,1,2,146,53,138,61,34,165
15K656,2015,197,165,154,17,3,9,133,39,8,0,8,148,49,154,43,21,176
15K656,2014,185,151,134,14,6,3,133,38,4,0,7,138,47,137,48,27,158
15K656,2013,200,147,147,17,2,5,140,47,4,0,4,154,46,142,58,18,182
15K656,2012,225,180,174,11,4,5,145,57,5,4,9,164,61,174,51,21,204
15K656,2011,124,111,109,4,2,2,102,19,0,1,0,92,32,98,26,8,116
15K656,2010,165,111,105,11,2,7,122,31,5,0,0,111,54,131,34,17,148
15K656,2009,157,119,117,3,4,1,113,38,4,1,0,94,63,115,42,8,149
15K656,2008,176,129,126,13,6,2,133,34,6,1,0,105,71,125,51,15,161
15K656,2007,96,78,71,3,2,2,72,19,1,2,0,58,38,65,31,4,92
15K656,2006,100,72,57,8,2,2,80,16,1,1,0,60,40,71,29,8,92
15K656,2005,154,106,78,18,4,5,110,35,4,0,0,90,64,79,75,7,147
15K656,2004,207,131,41,11,5,3,148,49,5,2,0,131,76,134,73,24,183
15K656,2003,147,105,53,4,3,1,113,31,2,0,0,91,56,71,76,2,145
15K656,2002,107,75,45,1,1,0,79,20,8,0,0,56,51,27,80,0,107
15K656,2001,147,105,54,1,2,0,122,21,4,0,0,81,66,32,115,6,141
15K667,2017,269,236,236,78,17,27,23,191,27,1,0,139,130,205,64,40,229
15K667,2016,280,250,249,31,16,29,25,204,22,0,0,132,148,237,43,49,231
15K667,2015,286,218,192,38,16,16,20,225,23,0,2,138,148,249,37,61,225
15K667,2014,304,244,210,25,19,31,21,230,21,1,0,136,168,258,46,62,242
15K667,2013,267,205,171,10,25,18,25,204,20,0,0,129,138,206,61,61,206
15K667,2012,313,200,175,7,25,21,30,244,16,2,0,139,174,230,83,63,250
15K667,2011,316,200,177,2,21,17,21,251,27,0,0,149,167,236,80,59,257
15K667,2010,296,193,170,2,15,14,13,250,19,0,0,136,160,242,54,76,220
15K667,2009,302,199,177,5,16,17,25,243,16,1,0,162,140,217,85,62,240
15K684,2017,173,172,172,154,1,19,29,29,90,0,6,93,80,67,106,31,142
15K684,2016,155,155,155,120,0,20,28,30,68,1,8,78,77,71,84,20,135
15K684,2015,159,157,157,108,1,18,32,41,56,2,10,85,74,63,96,25,134
15K684,2014,164,164,163,107,0,13,48,36,56,1,10,98,66,70,94,22,142
15K684,2013,164,160,160,74,0,7,48,46,46,1,16,87,77,74,90,20,144
15K684,2012,119,116,116,66,0,13,28,44,29,1,4,66,53,69,50,8,111
15K684,2011,113,107,107,45,1,19,26,28,40,0,0,69,44,40,73,12,101
15K698,2017,92,25,25,0,4,1,14,70,6,1,0,38,54,85,7,39,53
15K698,2016,62,13,13,0,2,2,13,45,0,2,0,29,33,54,8,23,39
15K698,2015,63,6,5,0,9,3,23,30,5,4,0,31,32,58,5,25,38
15K698,2014,65,6,5,0,6,4,19,47,3,3,0,28,37,60,5,30,35
15K698,2013,76,5,5,0,8,1,15,43,9,6,0,30,46,62,14,25,51
15K698,2012,74,8,6,0,11,2,17,37,1,1,0,37,37,60,14,16,58
15K698,2011,58,2,2,0,6,3,24,38,4,0,0,26,32,45,13,19,39
15K698,2010,69,5,4,1,14,1,12,35,4,0,0,26,43,62,7,13,56
15K698,2009,52,4,2,0,8,1,17,56,7,0,0,22,30,43,9,10,42
15K698,2008,78,3,3,0,22,1,14,34,5,1,0,50,28,65,13,6,72
15K698,2007,81,13,6,0,14,1,17,41,3,1,0,45,36,65,16,8,73
15K698,2006,55,7,3,0,7,1,14,31,3,0,0,31,24,42,13,3,52
15K698,2005,63,7,1,0,4,0,17,44,1,0,1,36,27,45,18,3,60
15K698,2004,49,4,0,0,8,0,16,54,7,1,0,26,23,39,10,2,47
15K698,2003,67,6,3,0,10,0,14,45,8,0,0,34,33,48,19,6,61
15K698,2002,74,11,1,0,10,0,11,61,2,0,0,32,42,51,23,3,71
15K698,2001,77,19,4,0,16,0,9,62,6,0,0,39,38,55,22,3,74
16K393,2013,22,13,8,0,2,1,66,4,0,1,0,10,12,15,7,9,13
16K393,2012,19,9,9,0,3,0,1,0,0,0,0,12,7,12,7,3,16
16K393,2011,28,17,17,0,1,0,19,3,0,0,0,16,12,20,8,5,23
16K393,2010,33,15,15,1,4,0,16,3,0,0,0,14,19,32,1,10,23
16K393,2009,50,31,31,0,2,0,27,6,0,0,0,23,27,41,9,5,45
16K393,2008,47,20,18,0,3,0,46,4,0,0,0,23,24,32,15,12,35
16K393,2007,63,31,23,2,3,0,40,6,0,1,0,27,36,46,17,11,52
16K393,2006,71,55,45,3,1,0,51,9,1,2,0,26,45,52,19,10,61
16K393,2005,72,67,56,4,2,0,62,8,0,1,0,39,33,28,44,2,70
16K455,2017,76,59,59,22,4,5,81,10,2,2,0,26,50,65,11,24,52
16K455,2016,100,68,68,7,7,1,74,9,1,1,1,34,66,84,16,24,76
16K455,2015,87,57,51,3,5,2,73,9,1,0,0,32,55,71,16,24,63
16K455,2014,85,55,51,2,9,1,101,12,5,1,2,31,54,66,19,26,59
16K455,2013,122,75,66,2,19,2,119,8,1,0,2,40,82,103,19,47,75
16K455,2012,132,65,60,5,26,1,165,11,2,1,0,44,88,101,31,30,102
16K455,2011,180,90,85,6,50,2,281,31,6,4,0,72,108,131,49,39,141
16K455,2010,324,129,118,1,47,3,412,39,4,2,0,132,192,238,86,78,246
16K455,2009,460,160,153,1,70,3,420,32,5,1,0,161,299,313,147,87,373
16K455,2008,461,140,135,5,80,6,516,42,6,6,0,184,277,313,148,106,355
16K455,2007,576,219,188,7,115,3,474,42,5,6,0,228,348,347,229,122,454
16K455,2006,530,206,169,9,102,3,736,63,4,9,0,214,316,335,195,108,422
16K455,2005,815,303,203,14,98,8,921,83,5,7,1,363,452,588,227,177,638
16K455,2004,1025,435,244,14,92,6,818,75,4,5,21,487,538,688,337,192,833
16K455,2003,929,358,168,13,119,4,658,48,5,1,0,448,481,520,409,122,807
16K455,2002,716,306,170,18,95,5,531,47,5,0,0,393,323,244,472,87,629
16K455,2001,588,279,149,22,140,0,64,9,1,1,1,319,269,193,395,90,498
16K498,2017,109,88,88,22,0,8,65,29,4,0,3,42,67,84,25,21,88
16K498,2016,111,95,87,4,3,3,72,28,3,2,3,54,57,92,19,19,92
16K498,2015,126,96,74,0,2,5,81,36,1,1,2,56,70,110,16,29,97
16K498,2014,140,115,104,12,10,5,89,40,4,1,1,53,87,118,22,27,113
16K498,2013,163,110,106,14,8,5,115,36,3,2,2,55,108,142,21,27,136
16K498,2012,144,95,93,9,8,3,118,22,0,0,1,61,83,106,38,27,117
16K498,2011,109,76,72,5,5,3,74,30,2,0,0,42,67,90,19,20,89
16K498,2010,78,61,57,2,5,1,54,23,0,0,0,40,38,61,17,17,61
16K498,2009,92,45,43,0,13,1,106,23,1,1,0,42,50,83,9,19,73
16K498,2008,99,70,67,2,16,1,106,27,0,1,0,46,53,99,0,20,79
16K498,2007,117,84,71,1,10,2,108,25,2,1,2,58,59,112,5,22,95
16K498,2006,96,72,60,2,6,0,65,27,0,0,0,58,38,90,6,18,78
16K498,2005,132,89,62,13,18,0,77,19,1,1,1,68,64,95,37,26,106
16K498,2004,135,74,35,9,25,0,85,32,0,0,0,71,64,105,30,17,118
16K498,2003,140,63,29,3,25,0,67,28,0,0,1,80,60,95,45,26,114
16K498,2002,126,38,20,0,16,0,96,27,3,0,0,69,57,73,53,17,109
16K498,2001,103,40,14,0,21,0,76,25,1,0,1,63,40,60,43,16,87
16K669,2017,68,15,14,0,10,1,97,21,2,0,1,34,34,64,4,18,50
16K669,2016,122,24,19,1,3,3,106,26,6,0,0,61,61,109,13,36,86
16K669,2015,141,40,29,0,17,1,80,28,3,2,0,62,79,119,22,45,96
16K669,2014,114,27,14,0,23,1,89,14,0,0,0,54,60,107,7,41,73
16K669,2013,96,18,14,0,18,1,70,9,1,0,0,46,50,85,11,35,61
16K669,2012,104,19,15,0,18,0,55,12,0,1,0,57,47,83,21,30,74
16K669,2011,81,15,12,0,10,0,82,10,1,3,0,45,36,64,17,26,55
16K669,2010,65,3,1,0,10,0,47,16,2,0,0,31,34,56,9,22,43
16K688,2017,23,19,17,0,1,4,15,4,0,0,0,12,11,22,1,10,13
16K688,2016,33,30,26,1,3,1,16,3,0,2,0,12,21,32,1,8,25
16K688,2015,22,16,6,0,3,2,31,9,1,0,0,10,12,21,1,7,15
16K688,2014,43,30,19,0,0,3,25,7,0,0,0,15,28,42,1,14,29
16K688,2013,35,23,17,0,4,3,25,8,0,0,0,17,18,27,8,8,27
16K688,2012,39,24,13,0,4,0,25,6,2,0,0,20,19,26,13,14,25
16K688,2011,36,21,19,1,8,0,29,9,1,0,0,16,20,22,14,7,29
16K688,2010,47,16,13,0,14,0,39,6,2,0,0,21,26,36,11,11,36
16K688,2009,52,25,24,0,10,0,40,10,1,1,0,26,26,52,0,10,42
16K765,2017,45,40,40,0,1,1,30,4,0,0,0,15,30,35,10,12,33
16K765,2016,35,30,30,0,1,2,56,5,1,1,1,18,17,25,10,11,24
16K765,2015,66,51,39,0,5,0,40,3,1,0,1,31,35,46,20,18,48
16K765,2014,72,59,51,0,2,0,60,9,2,1,0,29,43,57,15,15,57
17K122,2017,106,80,80,4,1,2,86,17,0,1,0,21,85,76,30,23,83
17K122,2016,121,77,77,0,2,1,100,16,3,1,0,31,90,82,39,16,105
17K122,2015,116,81,78,0,3,3,100,11,0,1,1,31,85,79,37,24,92
17K122,2014,109,71,67,0,1,4,73,10,0,0,1,43,66,76,33,18,91
17K122,2013,88,66,66,3,1,2,104,5,0,0,0,28,60,72,16,12,76
17K122,2012,111,64,61,2,2,7,74,16,0,0,0,17,94,74,37,16,95
17K122,2011,97,56,54,5,0,0,100,9,0,0,0,29,68,66,31,14,83
17K382,2017,59,48,48,5,2,2,48,9,4,0,0,28,31,49,10,6,53
17K382,2016,63,47,47,5,12,2,46,11,1,4,0,23,40,41,22,8,55
17K382,2015,62,43,37,3,9,1,90,7,2,0,1,21,41,51,11,15,47
17K382,2014,64,45,44,1,5,1,90,3,2,0,0,31,33,55,9,10,54
17K382,2013,63,39,37,3,11,1,75,3,2,0,0,21,42,43,20,12,51
17K382,2012,95,53,52,10,11,0,51,7,1,0,0,34,61,74,21,20,75
17K382,2011,101,51,48,6,5,0,56,2,1,2,1,45,56,80,21,14,87
17K382,2010,89,56,47,8,3,0,55,8,0,0,0,46,43,68,21,18,71
17K382,2009,96,65,63,17,4,0,78,16,1,0,0,46,50,73,23,6,90
17K382,2008,80,54,48,5,8,0,82,7,0,0,0,34,46,53,27,15,65
17K382,2007,81,44,37,6,17,0,70,8,2,0,0,31,50,40,41,6,75
17K382,2006,69,58,51,12,3,0,65,3,1,0,0,33,36,30,39,5,64
17K408,2017,62,49,49,12,2,1,39,12,4,0,0,34,28,57,5,14,48
17K408,2016,56,48,48,12,5,1,30,3,2,0,0,24,32,50,6,11,45
17K408,2015,36,31,22,0,2,1,47,0,1,1,0,17,19,35,1,11,25
17K408,2014,50,44,36,0,4,2,41,9,1,0,0,31,19,44,6,16,34
17K408,2013,53,27,24,0,10,5,49,4,0,0,0,30,23,51,2,13,40
17K408,2012,58,27,25,0,12,2,71,6,0,1,0,25,33,48,10,10,48
17K408,2011,80,49,46,0,6,1,62,5,1,1,0,41,39,72,8,16,64
17K408,2010,70,41,37,0,3,2,66,13,1,0,0,40,30,61,9,9,61
17K408,2009,70,28,28,0,7,1,70,9,1,0,0,31,39,58,12,8,62
17K408,2008,82,46,43,0,8,0,45,11,5,1,0,35,47,66,16,11,71
17K408,2007,75,54,48,0,7,0,60,10,0,0,0,40,35,50,25,5,70
17K408,2006,81,56,42,1,3,0,62,11,2,0,0,41,40,54,27,4,77
17K440,2002,196,97,34,0,74,0,1,0,0,0,0,0,1,110,86,36,282
17K440,2001,318,108,25,0,93,0,2,0,0,0,0,0,2,164,154,1,0
17K459,2002,107,66,30,7,20,9,151,15,1,2,0,86,92,83,95,4,103
17K459,2001,178,69,28,3,47,0,0,1,0,0,0,0,1,0,1,14,164
17K469,2003,65,31,4,0,17,4,141,15,3,0,0,105,81,59,6,10,55
17K469,2002,186,72,31,1,41,0,1,1,0,0,0,73,90,98,88,11,175
17K469,2001,163,53,12,0,42,0,59,6,0,0,0,0,2,104,59,15,148
17K470,2003,8,0,0,0,3,3,286,42,2,0,0,89,109,4,4,23,175
17K470,2002,198,96,49,3,66,0,4,0,0,0,0,162,171,113,85,55,278
17K470,2001,333,122,23,0,94,0,7,1,0,0,0,0,4,166,167,4,0
17K479,2003,82,51,18,2,23,3,171,18,0,0,0,84,108,65,17,16,176
17K479,2002,192,103,38,12,19,0,1,0,0,0,0,0,1,103,89,20,172
17K479,2001,192,90,40,5,27,0,1,0,0,0,0,0,1,129,63,1,0
17K489,2015,10,4,3,0,6,1,43,9,0,0,0,20,15,10,0,1,9
17K489,2014,35,10,7,0,15,1,52,4,2,1,0,24,31,31,4,4,31
17K489,2013,55,4,3,0,15,2,86,7,0,1,0,19,21,40,15,3,52
17K489,2012,40,4,4,0,10,2,151,15,0,3,0,32,18,30,10,9,31
17K489,2011,50,4,3,0,13,2,104,7,0,0,1,29,24,42,8,8,42
17K489,2010,53,4,4,0,11,1,90,6,0,0,1,30,30,45,8,7,46
17K489,2009,60,5,5,0,20,2,125,8,3,0,0,49,47,49,11,6,54
17K489,2008,96,11,9,0,35,0,2,0,0,0,0,93,78,96,0,9,87
17K489,2007,171,22,14,0,48,0,10,0,0,0,0,48,33,169,2,17,154
17K489,2006,81,16,7,0,28,0,27,6,2,0,0,71,43,77,4,7,74
17K489,2005,114,27,8,0,20,0,44,4,1,1,0,74,57,86,28,8,106
17K489,2004,131,13,2,0,26,0,73,8,0,0,0,56,42,111,20,5,126
17K489,2003,98,13,2,0,10,0,123,8,0,0,0,71,52,74,24,13,85
17K489,2002,123,9,2,0,12,0,113,6,2,2,0,71,67,109,14,4,119
17K489,2001,138,18,3,0,11,0,0,1,0,0,0,0,2,118,20,8,130
17K524,2017,83,66,66,0,6,14,20,41,5,3,0,34,49,71,12,2,81
17K524,2016,100,76,76,0,7,24,15,44,16,1,0,35,65,80,20,6,94
17K524,2015,104,51,45,0,14,11,24,65,2,2,0,44,60,83,21,8,96
17K524,2014,104,72,61,0,12,16,26,45,16,1,0,52,52,85,19,8,96
17K524,2013,93,57,52,0,14,21,23,41,8,0,0,36,57,60,33,10,83
17K524,2012,79,55,50,0,11,7,28,32,12,0,0,38,41,41,38,8,71
17K524,2011,104,70,66,0,7,21,35,32,16,0,0,44,60,61,43,5,99
17K524,2010,77,34,33,0,4,21,17,28,11,0,0,30,47,52,25,3,74
17K524,2009,87,54,54,0,4,31,27,20,9,0,0,41,46,87,0,3,84
17K524,2008,87,48,48,0,5,22,27,29,8,0,1,40,47,87,0,4,83
17K524,2007,111,61,44,0,12,32,29,41,8,1,0,55,56,106,5,1,110
17K524,2006,84,33,33,0,7,16,25,28,15,0,0,37,47,72,12,4,80
17K524,2005,102,57,29,0,7,37,21,38,6,0,0,60,42,93,9,8,94
17K524,2004,90,49,21,0,7,33,16,33,7,1,0,37,53,75,15,7,83
17K528,2017,46,40,40,13,4,1,31,11,0,2,1,12,34,42,4,7,39
17K528,2016,53,46,43,3,7,3,43,4,1,1,1,15,38,44,9,10,43
17K528,2015,37,31,24,0,4,3,28,5,1,0,0,17,20,32,5,4,33
17K528,2014,50,39,35,0,6,2,39,9,0,0,0,27,23,44,6,5,45
17K528,2013,59,32,25,0,10,2,45,9,2,1,0,31,28,54,5,9,50
17K528,2012,57,33,27,0,7,1,49,8,3,0,0,22,35,39,18,15,42
17K528,2011,61,34,31,0,13,2,73,9,0,0,0,35,26,50,11,8,53
17K528,2010,84,46,43,0,10,1,79,5,3,0,0,37,47,67,17,16,68
17K528,2009,88,45,38,0,20,1,92,8,1,1,1,43,45,67,21,12,76
17K528,2008,89,65,60,0,11,2,84,12,0,0,0,41,48,55,34,11,78
17K528,2007,118,52,42,3,20,1,1,0,0,0,0,69,49,117,1,16,102
17K528,2006,104,64,47,5,15,0,51,6,0,0,0,57,47,102,2,9,95
17K528,2005,101,54,43,5,8,0,79,8,0,2,0,59,42,99,2,8,93
17K528,2004,98,63,54,10,10,0,102,16,0,0,0,57,41,78,20,8,90
17K531,2017,78,67,67,12,0,2,70,6,0,0,0,43,35,75,3,11,67
17K531,2016,74,61,61,2,1,1,62,7,3,0,1,36,38,63,11,17,57
17K531,2015,104,77,69,2,8,1,110,6,1,0,0,37,67,86,18,25,79
17K531,2014,118,95,82,5,5,1,52,6,0,0,0,65,53,102,16,21,97
17K531,2013,59,41,40,1,3,1,68,2,2,0,0,26,33,48,11,8,51
17K531,2012,78,53,53,3,6,1,59,4,1,0,0,42,36,62,16,17,61
17K531,2011,73,54,54,7,3,1,49,5,0,0,0,39,34,60,13,9,64
17K531,2010,65,44,40,2,3,2,64,5,0,0,0,25,40,58,7,11,54
17K531,2009,60,40,36,7,7,0,99,4,1,0,0,32,28,52,8,13,47
17K531,2008,59,45,44,4,5,0,71,7,0,0,0,25,34,43,16,9,50
17K531,2007,75,46,36,14,11,0,58,2,0,0,0,36,39,43,32,9,66
17K531,2006,60,49,24,6,4,0,56,3,0,0,0,27,33,53,7,12,48
17K531,2005,55,38,20,0,5,0,70,3,2,0,0,28,27,39,16,4,51
17K531,2004,71,40,13,0,7,0,56,4,0,0,0,33,38,33,38,2,69
17K533,2013,55,27,22,0,8,1,61,6,1,0,0,28,46,33,22,10,45
17K533,2012,74,34,24,0,10,0,2,0,0,0,0,44,40,51,23,22,52
17K533,2011,84,46,41,0,9,0,3,1,1,0,0,27,42,61,23,17,67
17K533,2010,69,40,33,5,2,0,68,2,2,2,0,32,40,57,12,21,48
17K533,2009,72,35,27,2,14,0,65,5,0,2,0,45,32,58,14,16,56
17K533,2008,77,42,40,2,8,0,70,5,2,0,0,41,43,59,18,12,65
17K533,2007,84,49,38,0,8,0,79,4,1,0,0,50,24,51,33,12,72
17K533,2006,74,0,0,0,6,0,62,10,1,0,1,32,25,57,17,17,57
17K533,2005,57,39,20,0,3,0,53,2,2,0,0,41,28,37,20,7,50
17K533,2004,69,54,31,0,3,0,66,3,0,0,0,1,0,44,25,8,61
17K537,2017,131,108,108,4,13,6,99,20,4,2,0,31,100,103,28,33,98
17K537,2016,121,98,95,5,12,4,102,12,2,0,1,37,84,86,35,27,94
17K537,2015,98,79,63,3,10,2,73,19,3,0,1,26,72,79,19,26,72
17K537,2014,125,99,79,3,11,1,101,18,3,0,2,47,78,102,23,30,95
17K537,2013,97,70,50,1,12,3,82,7,2,1,0,40,57,75,22,31,66
17K537,2012,95,72,66,1,10,2,86,7,0,0,0,44,51,79,16,23,72
17K537,2011,95,73,63,3,8,1,79,5,3,2,1,36,59,78,17,26,69
17K537,2010,91,62,55,2,12,1,86,10,2,1,0,33,58,73,18,16,75
17K537,2009,100,63,55,4,10,1,90,11,0,1,0,30,70,85,15,18,82
17K537,2008,103,70,64,4,14,1,107,12,0,1,0,45,58,83,20,12,91
17K537,2007,121,61,44,0,26,2,90,6,2,0,0,48,73,74,47,18,103
17K537,2006,100,56,42,6,8,1,101,16,0,0,0,48,52,76,24,8,92
17K537,2005,118,51,22,0,26,1,89,10,2,2,0,59,59,114,4,11,107
17K537,2004,104,58,29,8,9,0,82,10,3,1,1,56,48,104,0,12,92
17K537,2003,6,0,0,0,0,0,6,0,0,0,0,3,3,6,0,3,3
17K539,2017,70,57,57,21,9,4,46,16,3,0,1,30,40,50,20,11,59
17K539,2016,63,46,44,11,12,2,48,9,2,0,2,27,36,47,16,11,52
17K539,2015,79,62,47,1,10,4,59,11,4,1,0,24,55,58,21,13,66
17K539,2014,121,94,71,6,19,3,91,20,4,1,2,43,78,93,28,28,93
17K539,2013,82,68,61,4,9,3,68,8,1,2,0,25,57,62,20,17,65
17K539,2012,106,78,74,10,12,2,86,13,1,2,2,40,66,84,22,16,90
17K539,2011,117,82,73,7,12,4,100,10,2,1,0,31,86,81,36,28,89
17K539,2010,105,81,76,9,7,2,94,5,3,0,1,41,64,82,23,22,83
17K539,2009,92,63,60,9,14,2,100,10,0,0,0,41,51,68,24,17,75
17K539,2008,112,80,78,13,17,1,100,13,0,0,0,41,71,91,21,20,92
17K539,2007,114,86,76,18,12,1,102,13,0,0,0,50,64,82,32,15,99
17K539,2006,116,90,71,13,15,1,75,17,0,0,0,55,61,96,20,16,100
17K539,2005,111,87,64,13,10,0,83,9,0,0,0,56,55,109,2,9,102
17K539,2004,93,67,42,2,14,0,106,5,0,0,0,58,35,93,0,19,74
17K539,2003,11,0,0,0,4,0,8,3,0,0,0,5,6,10,1,2,9
17K543,2017,85,85,85,37,0,7,64,11,1,2,0,38,47,53,32,12,73
17K543,2016,93,92,92,38,0,3,75,13,1,1,0,50,43,69,24,10,83
17K543,2015,90,90,89,25,0,2,81,3,1,3,0,42,48,76,14,6,84
17K543,2014,74,67,67,24,2,6,61,5,1,1,0,34,40,65,9,6,68
17K543,2013,85,83,83,14,1,6,73,5,1,0,0,34,51,70,15,0,85
17K543,2012,78,74,73,11,0,1,70,6,0,1,0,43,35,64,14,2,76
17K543,2011,71,68,66,6,0,2,65,3,1,0,0,38,33,58,13,2,69
17K543,2010,83,79,79,6,0,3,57,16,0,1,6,31,52,69,14,2,81
17K543,2009,81,75,75,3,1,5,67,6,2,1,0,42,39,61,20,3,78
17K543,2008,71,68,68,3,1,3,58,8,2,0,0,36,35,53,18,1,70
17K543,2007,70,64,64,4,1,4,61,3,1,1,0,42,28,50,20,0,70
17K543,2006,76,75,71,0,0,4,69,2,0,0,1,43,33,55,21,0,76
17K543,2005,90,88,81,14,0,2,77,9,1,1,0,49,41,90,0,1,89
17K543,2004,101,94,85,27,0,3,84,12,1,0,1,44,57,101,0,1,100
17K543,2003,74,69,48,6,0,1,62,8,1,0,2,39,35,74,0,3,71
17K544,2011,17,12,12,0,5,1,14,2,0,0,0,9,8,13,4,2,15
17K544,2010,61,43,38,0,11,1,74,12,0,3,0,30,31,51,10,9,52
17K544,2009,90,44,37,0,12,0,56,3,2,0,0,42,48,64,26,16,74
17K544,2008,83,45,42,1,15,0,73,9,1,0,0,45,38,66,17,13,70
17K544,2007,100,51,40,0,7,0,86,14,0,0,0,60,40,79,21,17,83
17K544,2006,108,53,35,3,7,0,97,9,0,2,0,65,43,65,43,17,91
17K544,2005,96,52,35,4,7,0,86,10,0,0,0,66,30,64,32,3,93
17K544,2004,79,59,37,4,3,0,78,1,0,0,0,51,28,61,18,5,74
17K544,2003,81,57,32,0,13,0,75,5,0,0,1,39,42,57,24,6,75
17K544,2002,6,0,0,0,2,0,5,1,0,0,0,3,3,4,2,2,4
17K546,2017,107,98,98,22,2,4,88,12,0,0,3,71,36,75,32,20,87
17K546,2016,104,99,95,30,1,4,82,17,0,1,0,75,29,87,17,10,94
17K546,2015,105,89,81,18,1,5,79,14,3,0,4,68,37,83,22,18,87
17K546,2014,116,108,101,24,2,7,84,23,1,0,1,70,46,93,23,12,104
17K546,2013,93,88,83,23,1,4,72,15,1,0,1,63,30,76,17,13,80
17K546,2012,104,97,93,18,0,2,84,17,1,0,0,64,40,81,23,8,96
17K546,2011,109,101,97,23,2,8,82,17,2,0,0,87,22,84,25,7,102
17K546,2010,106,95,95,6,0,4,95,5,2,0,0,78,28,93,13,8,98
17K546,2009,89,82,77,1,1,2,82,5,0,0,0,61,28,74,15,6,83
17K546,2008,79,70,69,9,0,1,66,12,0,0,0,60,19,66,13,1,78
17K546,2007,102,87,71,13,1,1,79,13,0,0,0,81,21,75,27,11,91
17K546,2006,93,88,80,16,0,3,83,8,0,0,0,74,19,66,27,8,85
17K546,2005,94,91,84,11,0,0,88,14,0,0,0,76,18,73,21,5,89
17K546,2004,72,66,53,0,4,0,65,7,0,0,0,49,23,54,18,3,69
17K546,2003,84,78,52,1,2,0,75,9,0,0,0,61,23,68,16,1,83
17K547,2017,92,63,63,26,2,1,72,13,4,1,1,37,55,66,26,14,78
17K547,2016,89,69,68,21,7,8,68,11,2,0,0,36,53,73,16,9,80
17K547,2015,120,81,73,0,10,4,102,10,2,1,1,39,81,93,27,20,100
17K547,2014,87,54,49,1,9,4,75,6,1,1,0,36,51,73,14,15,72
17K547,2013,97,66,62,5,9,5,83,8,1,0,0,37,60,71,26,19,78
17K547,2012,146,106,101,13,8,7,116,22,1,0,0,59,87,108,38,22,124
17K547,2011,140,88,86,6,10,8,114,17,1,0,0,59,81,105,35,19,121
17K547,2010,101,75,71,6,7,1,86,14,0,0,0,53,48,84,17,13,88
17K547,2009,110,64,62,2,8,8,88,13,0,1,0,56,54,83,27,12,98
17K547,2008,109,68,64,2,7,1,111,13,3,1,0,40,69,79,30,14,95
17K547,2007,129,82,72,11,12,2,90,14,2,2,0,67,62,113,16,19,110
17K547,2006,110,76,50,7,6,1,94,17,0,0,0,53,57,92,18,11,99
17K547,2005,112,74,59,12,5,1,81,3,1,0,1,45,67,88,24,10,102
17K547,2004,87,59,42,10,1,3,107,9,2,0,1,46,41,71,16,3,84
17K547,2003,122,71,45,3,2,0,91,13,4,1,0,62,60,85,37,4,118
17K548,2017,68,54,54,14,4,1,53,14,0,0,0,56,12,52,16,13,55
17K548,2016,54,43,42,3,3,1,59,16,1,0,0,32,22,44,10,13,41
17K548,2015,66,49,32,1,8,1,79,14,0,0,0,45,21,47,19,19,47
17K548,2014,77,57,51,0,6,3,71,10,0,0,0,61,16,63,14,10,67
17K548,2013,82,57,51,0,9,1,85,8,2,2,0,60,22,72,10,16,66
17K548,2012,77,66,60,0,1,2,61,5,2,1,0,47,30,64,13,9,68
17K548,2011,94,73,64,1,11,0,45,9,0,0,0,61,33,75,19,15,79
17K548,2010,83,53,50,1,9,0,53,9,2,1,1,56,27,64,19,11,72
17K548,2009,84,49,45,4,6,0,67,15,0,0,0,56,28,67,17,9,75
17K548,2008,81,53,51,6,3,0,70,6,1,0,0,60,21,56,25,9,72
17K548,2007,88,60,46,6,5,0,69,13,1,0,0,62,26,88,0,6,82
17K548,2006,88,65,44,3,2,0,67,14,0,0,0,59,29,87,1,13,75
17K548,2005,98,80,57,13,3,0,77,10,0,1,0,72,26,98,0,13,85
17K548,2004,71,60,48,10,1,0,75,9,3,0,1,56,15,55,16,5,66
17K548,2003,97,77,38,5,3,0,85,8,1,1,2,72,25,75,22,6,91
17K568,2017,34,4,4,0,3,3,61,7,0,2,0,16,18,30,4,11,23
17K568,2016,73,17,12,0,6,1,76,5,0,1,0,39,34,61,12,17,56
17K568,2015,72,17,13,0,8,2,65,12,0,0,1,41,31,57,15,19,53
17K568,2014,51,10,7,0,7,1,69,10,0,1,4,31,20,44,7,10,41
17K568,2013,47,10,9,0,8,1,76,8,1,1,2,25,22,34,13,9,38
17K568,2012,83,16,13,0,9,1,70,6,0,1,0,54,29,71,12,14,69
17K568,2011,80,21,18,0,10,1,53,10,0,0,0,46,34,71,9,9,71
17K568,2010,85,17,16,0,13,0,28,5,1,0,0,58,27,70,15,10,75
17K568,2009,83,17,16,0,15,0,50,17,1,2,2,51,32,72,11,6,77
17K568,2008,89,27,26,0,12,0,42,5,1,2,1,59,30,82,7,8,81
17K568,2007,89,22,14,0,17,0,40,6,0,0,1,53,36,74,15,7,82
17K568,2006,75,9,5,0,15,0,71,10,0,0,2,40,35,61,14,2,73
17K568,2005,86,11,5,0,7,0,70,12,3,1,3,55,31,75,11,4,82
17K568,2004,63,7,3,0,7,0,65,8,1,1,0,38,25,54,9,4,59
17K568,2003,94,11,2,0,7,0,70,15,0,1,0,48,46,80,14,9,85
17K568,2002,78,2,1,0,8,0,55,5,2,1,0,45,33,51,27,5,73
17K568,2001,64,0,0,0,1,0,79,15,0,0,0,39,25,42,22,3,61
17K590,2017,234,225,219,39,0,6,202,11,2,8,5,157,77,200,34,15,219
17K590,2016,196,187,182,56,2,3,175,11,0,2,5,111,85,129,67,13,183
17K590,2015,197,183,179,81,2,7,165,17,4,1,3,100,97,146,51,9,188
17K590,2014,207,199,196,45,0,5,185,9,0,1,7,128,79,169,38,11,196
17K590,2013,239,230,230,107,0,7,216,9,2,0,5,128,111,189,50,9,230
17K590,2012,235,220,220,70,0,6,211,9,1,1,7,142,93,165,70,4,231
17K590,2011,219,209,209,72,1,7,208,4,0,0,0,114,105,161,58,6,213
17K590,2010,226,199,195,33,3,1,164,5,0,0,0,126,100,164,62,4,222
17K590,2009,206,195,195,39,1,1,146,12,1,0,0,121,85,153,53,1,205
17K590,2008,170,163,163,38,2,2,150,10,0,0,0,108,62,115,55,1,169
17K590,2007,160,153,148,52,0,2,143,7,1,2,0,73,87,125,35,3,157
17K590,2006,156,146,143,47,6,3,164,9,0,3,2,76,80,126,30,1,155
17K590,2005,162,149,145,53,2,2,194,7,17,2,0,76,86,135,27,3,159
17K590,2004,155,138,116,28,4,1,180,4,24,0,0,93,62,42,113,7,148
17K590,2003,181,156,133,44,6,0,223,2,1,0,0,127,54,67,114,7,174
17K590,2002,222,181,163,65,7,0,199,7,0,0,0,135,87,88,134,6,216
17K590,2001,209,174,141,50,6,0,144,8,2,2,0,132,77,82,127,4,205
17K600,2017,277,193,193,51,10,4,246,19,5,2,1,205,72,223,54,52,225
17K600,2016,282,202,201,13,11,5,256,16,3,2,0,218,64,203,79,49,233
17K600,2015,258,189,172,11,10,2,228,20,2,6,0,189,69,193,65,50,208
17K600,2014,286,206,190,8,8,3,253,18,1,3,8,191,95,227,59,42,244
17K600,2013,285,197,182,12,15,3,265,15,1,1,0,193,92,241,44,57,228
17K600,2012,332,220,205,15,23,6,307,14,4,1,0,256,76,257,75,56,276
17K600,2011,330,207,202,10,14,3,308,14,3,2,0,241,89,263,67,52,278
17K600,2010,326,237,234,11,3,8,294,18,5,1,0,250,76,252,74,31,295
17K600,2009,402,256,253,21,14,7,373,19,1,2,0,312,90,304,98,37,365
17K600,2008,391,251,246,12,25,8,352,27,2,2,0,295,96,292,99,52,339
17K600,2007,454,265,227,17,58,4,418,30,1,0,1,336,118,371,83,53,401
17K600,2006,488,296,209,30,63,6,437,33,8,4,0,377,111,396,92,51,437
17K600,2005,489,324,226,19,34,7,441,34,3,1,3,370,119,380,109,45,444
17K600,2004,539,330,200,34,40,9,459,56,6,4,5,387,152,439,100,52,487
17K600,2003,501,328,217,49,63,11,434,48,1,5,2,360,141,341,160,50,451
17K600,2002,473,314,191,43,35,11,407,25,27,3,0,368,105,347,126,31,442
17K600,2001,464,278,172,44,50,7,388,53,13,3,0,365,99,290,174,60,404
17K625,2010,24,11,11,0,12,2,137,17,5,2,0,42,51,16,8,7,17
17K625,2009,93,36,34,3,22,1,244,18,1,4,0,71,92,73,20,24,69
17K625,2008,163,62,58,5,42,2,255,26,4,5,0,110,158,127,36,43,120
17K625,2007,268,126,86,9,55,4,235,25,3,0,2,121,171,213,55,47,221
17K625,2006,292,136,69,10,37,1,244,27,3,0,1,126,196,235,57,50,242
17K625,2005,322,122,35,5,25,3,239,22,7,1,0,101,168,245,77,45,277
17K625,2004,269,149,54,1,20,0,1,0,0,0,0,148,128,253,16,24,245
17K625,2003,276,154,62,11,24,0,23,1,0,0,0,126,146,224,52,32,244
17K625,2002,272,125,59,10,38,0,292,29,0,1,0,157,130,202,70,19,253
17K625,2001,287,157,73,15,23,0,256,25,4,2,0,0,1,220,67,18,269
17K646,2017,56,9,9,0,3,2,46,7,1,0,0,32,24,45,11,14,42
17K646,2016,95,14,14,1,17,1,80,12,1,1,0,43,52,81,14,23,72
17K646,2015,90,7,5,0,20,1,73,15,0,0,1,45,45,75,15,26,64
17K646,2014,32,14,9,0,16,2,80,29,1,0,0,20,12,30,2,9,23
17K646,2013,109,22,18,0,5,3,79,17,2,2,0,50,59,88,21,14,95
17K646,2012,112,13,12,0,18,1,47,23,1,2,0,55,57,79,33,17,95
17K646,2011,103,15,9,0,22,5,95,21,1,2,0,58,45,89,14,16,87
17K646,2010,74,5,3,0,11,1,83,19,0,0,0,39,35,67,7,12,62
17K646,2009,124,18,15,0,29,0,24,8,0,0,0,70,54,101,23,18,106
17K646,2008,122,11,8,0,31,0,83,22,1,3,0,64,58,106,16,10,112
17K646,2007,103,7,4,0,39,0,87,34,1,0,0,57,46,75,28,8,95
17K646,2006,117,16,7,0,34,0,94,23,0,0,0,68,49,101,16,8,109
17K646,2005,53,3,2,0,4,0,40,12,0,1,0,32,21,42,11,7,46
17K745,2017,95,87,87,0,1,3,79,12,0,1,0,54,41,78,17,15,80
17K745,2016,106,98,85,0,2,2,97,7,0,0,0,64,42,90,16,18,88
17K745,2015,84,78,69,0,2,1,74,7,1,1,0,40,44,59,25,17,67
17K745,2014,77,75,67,0,1,1,74,2,0,0,0,33,44,72,5,11,66
17K745,2013,85,78,70,0,1,4,85,6,0,1,0,44,41,78,7,17,68
17K745,2012,96,87,75,5,1,0,80,2,1,2,0,49,47,88,8,22,74
17K751,2017,55,41,41,1,0,1,42,9,0,0,3,39,16,43,12,9,46
17K751,2016,82,68,68,2,4,3,66,12,0,0,1,60,22,74,8,10,72
17K751,2015,74,56,48,0,8,4,57,8,3,0,2,56,18,60,14,9,65
17K751,2014,86,68,63,1,3,2,75,5,1,0,3,59,27,75,11,11,75
17K751,2013,81,64,57,0,6,3,67,7,1,1,2,58,23,63,18,13,68
17K751,2012,72,52,48,3,3,1,65,4,1,0,1,54,18,55,17,10,62
17K751,2011,81,57,54,0,9,2,67,11,1,0,0,52,29,74,7,12,69
17K751,2010,31,15,12,1,5,1,28,2,0,0,0,23,8,29,2,5,26
18K415,2006,178,105,38,7,28,3,508,31,2,0,2,155,181,231,105,34,144
18K415,2005,336,124,64,12,55,3,461,29,4,1,0,204,275,263,216,65,271
18K415,2004,479,200,108,13,64,2,420,18,6,2,0,277,269,243,303,59,420
18K415,2003,546,215,122,22,108,0,1,0,0,0,0,227,271,152,346,79,467
18K415,2002,498,194,88,20,49,0,168,9,0,0,1,223,225,151,297,42,456
18K415,2001,448,185,95,23,83,0,308,20,0,6,2,0,1,0,1,33,415
18K500,2007,248,95,53,5,57,6,356,50,11,3,5,208,223,165,266,81,350
18K500,2006,431,182,72,7,97,6,502,60,6,3,0,271,306,217,360,95,482
18K500,2005,577,209,89,11,93,12,507,63,11,1,0,255,339,206,388,106,488
18K500,2004,594,195,77,8,84,9,534,81,12,1,0,271,366,207,430,123,514
18K500,2003,637,201,89,5,98,10,502,62,19,1,0,249,345,149,445,78,516
18K500,2002,594,172,70,20,113,14,473,68,19,0,0,246,328,106,468,112,462
18K500,2001,574,231,107,0,80,0,1,0,0,0,0,0,1,0,1,1,0
18K515,2006,125,53,19,5,49,2,111,10,2,0,0,48,77,70,55,28,97
18K515,2005,257,93,32,2,76,4,228,19,4,1,1,129,128,111,146,43,214
18K515,2004,395,112,34,4,106,2,362,24,7,0,0,178,217,151,244,62,333
18K515,2003,524,165,62,0,119,2,462,51,7,1,1,243,281,184,340,82,442
18K515,2002,511,167,62,13,97,8,445,47,11,0,0,234,277,129,382,54,457
18K515,2001,460,163,17,4,119,5,424,25,6,0,0,211,249,87,373,61,399
18K563,2017,165,129,129,26,4,3,147,10,2,3,0,83,82,122,43,20,145
18K563,2016,210,178,178,37,7,5,185,14,4,2,0,91,119,148,62,24,186
18K563,2015,158,132,125,3,8,2,140,13,0,2,1,56,102,105,53,16,142
18K563,2014,150,131,128,3,4,2,129,12,2,4,1,70,80,108,42,19,131
18K563,2013,166,148,146,30,2,1,148,9,2,0,6,71,95,126,40,20,146
18K563,2012,125,108,106,0,3,4,70,0,0,0,0,54,71,82,43,17,108
18K563,2011,120,105,104,8,3,3,80,1,0,1,0,48,72,90,30,17,103
18K563,2010,98,84,77,10,7,4,97,6,0,0,0,49,49,87,11,20,78
18K563,2009,74,66,54,17,5,0,119,4,0,0,2,42,32,59,15,15,59
18K563,2008,85,65,59,1,4,0,116,4,0,0,0,48,37,74,11,11,74
18K563,2007,107,94,88,35,5,0,89,7,2,0,0,56,51,87,20,2,105
18K566,2017,51,41,41,2,5,3,31,5,2,1,2,19,32,41,10,10,41
18K566,2016,55,38,38,7,5,1,56,2,0,0,0,15,40,38,17,11,44
18K566,2015,48,36,31,0,8,1,80,6,3,0,1,20,28,32,16,10,38
18K566,2014,44,30,25,0,7,2,70,6,0,0,0,16,28,37,7,10,34
18K566,2013,59,35,33,3,9,1,71,6,0,0,0,25,34,44,15,6,53
18K566,2012,65,40,35,2,7,3,66,6,1,2,0,35,30,43,22,18,47
18K566,2011,82,53,52,0,8,0,40,6,4,1,0,41,41,69,13,12,70
18K566,2010,91,41,37,0,13,0,43,9,3,0,0,39,52,70,21,19,72
18K566,2009,78,35,34,0,15,0,40,6,1,1,0,27,51,58,20,13,65
18K566,2008,78,38,37,0,14,0,62,3,0,0,0,26,52,56,22,14,64
18K566,2007,78,43,34,0,10,0,69,8,2,3,0,24,54,43,35,14,64
18K567,2017,78,50,50,0,5,1,66,7,2,2,0,50,28,65,13,11,67
18K567,2016,92,61,61,0,5,2,79,7,1,2,1,51,41,71,21,16,76
18K567,2015,77,55,47,0,1,1,81,8,3,0,0,33,44,62,15,6,71
18K567,2014,79,53,48,0,5,0,66,9,1,1,0,49,30,62,17,12,67
18K567,2013,99,74,71,1,8,0,66,10,0,2,1,55,44,84,15,10,89
18K567,2012,66,39,38,0,9,0,82,10,1,1,5,42,24,56,10,14,52
18K567,2011,93,63,60,0,8,0,60,5,0,0,1,62,31,72,21,18,75
18K567,2010,85,49,46,0,11,0,74,9,2,0,0,51,34,78,7,22,63
18K567,2009,78,42,41,0,8,0,63,12,2,1,0,42,36,67,11,19,59
18K567,2008,79,47,43,0,6,0,64,12,3,0,0,49,30,60,19,14,65
18K567,2007,62,45,45,1,11,0,49,10,3,0,0,37,25,47,15,6,56
18K569,2017,74,48,48,0,4,1,59,12,2,0,0,24,50,62,12,21,53
18K569,2016,90,72,72,0,1,1,93,6,1,0,0,34,56,75,15,25,65
18K569,2015,89,62,62,0,3,1,62,7,0,0,0,42,47,76,13,24,65
18K569,2014,101,75,75,0,5,1,66,4,1,0,0,33,68,83,18,21,80
18K569,2013,70,58,55,0,4,1,75,6,0,1,0,32,38,60,10,9,61
18K569,2012,72,50,49,0,3,2,47,5,0,3,0,29,43,59,13,15,57
18K569,2011,83,63,56,0,6,0,84,5,0,1,0,34,49,62,21,18,65
18K569,2010,57,41,33,1,7,0,83,5,0,1,0,19,38,47,10,13,44
18K569,2009,88,49,45,0,9,0,74,12,2,0,0,22,66,69,19,19,69
18K569,2008,74,51,41,5,5,0,68,5,1,0,0,33,41,56,18,17,57
18K569,2007,89,58,48,3,11,0,81,7,0,0,1,35,54,65,24,7,82
18K576,2017,68,58,58,0,4,1,66,6,4,0,0,32,36,56,12,8,60
18K576,2016,77,67,67,0,3,1,67,6,3,2,0,40,37,60,17,15,62
18K576,2015,79,50,45,0,6,1,92,7,3,0,3,40,39,58,21,14,65
18K576,2014,106,84,71,0,6,1,56,4,0,0,3,44,62,85,21,20,86
18K576,2013,64,46,39,0,2,1,67,3,2,0,0,29,35,49,15,12,52
18K576,2012,73,51,36,0,8,1,67,7,0,1,0,24,49,43,30,18,55
18K576,2011,76,51,43,0,4,1,72,6,0,0,0,43,33,54,22,13,63
18K576,2010,77,43,37,0,6,1,73,5,2,0,0,38,39,65,12,14,63
18K576,2009,73,61,53,0,3,0,54,6,8,0,0,35,38,56,17,9,64
18K576,2008,79,68,66,3,3,0,73,2,1,1,0,41,38,67,12,9,70
18K576,2007,81,57,50,5,3,0,70,2,0,1,0,37,44,61,20,12,69
18K578,2017,68,12,10,0,16,2,61,4,1,0,0,24,44,47,21,18,50
18K578,2016,97,17,14,0,12,5,80,8,2,2,0,36,61,81,16,28,69
18K578,2015,85,9,8,0,13,1,73,9,1,1,0,35,50,67,18,18,67
18K578,2014,97,14,10,0,9,3,79,11,3,0,1,41,56,79,18,14,83
18K578,2013,62,13,13,0,6,2,68,9,3,2,0,20,42,51,11,13,49
18K578,2012,111,17,15,0,3,1,56,9,1,0,0,59,52,94,17,23,88
18K578,2011,84,12,12,0,11,1,96,13,1,1,0,37,47,69,15,14,70
18K578,2010,67,10,9,0,11,1,96,11,1,0,0,39,28,55,12,16,51
18K578,2009,112,15,12,0,22,3,86,5,4,0,0,52,60,94,18,22,90
18K578,2008,109,19,10,0,23,2,73,11,1,0,0,50,59,86,23,14,95
18K578,2007,98,11,6,0,14,1,78,3,2,0,0,42,56,72,26,15,83
18K578,2006,87,13,6,0,14,0,47,13,2,0,0,52,35,60,27,10,77
18K578,2005,84,11,4,0,8,0,98,8,2,2,1,48,36,52,32,6,78
18K578,2004,49,3,1,0,3,0,45,3,1,0,0,31,18,24,25,6,43
18K578,2003,15,0,0,0,0,0,14,1,0,0,0,6,9,7,8,3,12
18K589,2013,59,34,32,0,8,0,50,7,1,1,0,25,34,49,10,11,48
18K589,2012,55,37,33,0,4,0,70,10,0,0,0,30,25,48,7,9,46
18K589,2011,80,39,37,0,12,0,50,3,0,0,1,44,36,56,24,16,64
18K589,2010,54,28,21,0,4,0,50,6,0,0,0,30,24,39,15,12,42
18K589,2009,56,23,20,0,9,0,62,5,0,1,0,30,26,30,26,11,45
18K589,2008,68,43,36,0,4,0,4,0,0,0,0,36,32,43,25,12,56
18K589,2007,55,41,33,0,4,0,0,2,0,0,0,26,29,33,22,9,46
18K617,2017,55,42,42,0,6,1,43,8,2,1,0,8,47,42,13,13,42
18K617,2016,58,49,48,0,5,1,50,3,2,0,2,14,44,44,14,5,53
18K617,2015,61,48,43,0,3,1,51,7,1,0,1,21,40,45,16,12,49
18K617,2014,61,35,33,0,6,2,66,6,0,1,0,22,39,46,15,10,51
18K617,2013,66,41,40,0,5,1,61,3,1,0,0,21,45,55,11,11,55
18K617,2012,75,53,49,0,7,3,54,6,1,2,0,29,46,62,13,8,67
18K617,2011,66,50,47,0,5,1,67,11,0,1,0,24,42,46,20,10,56
18K617,2010,66,39,35,3,2,1,3,0,0,0,0,18,48,51,15,19,47
18K617,2009,80,50,43,0,8,0,49,11,0,1,0,37,43,66,14,19,61
18K617,2008,64,41,40,0,6,0,58,7,1,0,0,20,44,41,23,9,55
18K629,2017,61,54,54,5,3,1,66,4,2,2,0,32,29,46,15,10,51
18K629,2016,75,66,64,3,4,1,83,5,0,0,0,33,42,64,11,9,66
18K629,2015,80,52,47,1,12,1,72,7,0,1,0,36,44,60,20,14,66
18K629,2014,89,65,64,2,3,1,71,5,0,0,0,35,54,71,18,15,74
18K629,2013,88,61,45,10,8,1,52,9,1,0,0,41,47,67,21,21,67
18K629,2012,81,50,45,0,6,1,62,9,0,0,0,37,44,57,24,23,58
18K629,2011,74,42,40,1,6,0,53,5,0,1,2,33,41,58,16,14,60
18K629,2010,77,46,41,1,2,0,64,13,3,0,0,35,42,58,19,12,65
18K629,2009,63,37,32,2,3,0,81,5,2,0,0,29,34,55,8,12,51
18K629,2008,72,52,49,1,5,0,67,7,0,0,0,36,36,61,11,9,63
18K629,2007,7,0,0,0,2,0,5,2,0,0,0,3,4,4,3,3,4
18K633,2017,117,100,100,0,2,3,93,14,5,1,1,81,36,102,15,16,101
18K633,2016,94,84,84,0,4,1,76,12,4,0,1,61,33,84,10,15,79
18K633,2015,113,92,84,0,3,7,91,6,9,0,0,64,49,107,6,13,100
18K633,2014,112,98,92,0,1,2,98,11,1,0,0,78,34,107,5,12,100
18K633,2013,99,87,81,1,0,4,84,10,1,0,0,63,36,96,3,19,80
18K633,2012,111,95,93,2,3,2,88,18,1,2,0,81,30,98,13,15,96
18K633,2011,103,90,84,1,3,3,83,17,0,0,0,71,32,93,10,15,88
18K633,2010,117,101,99,5,1,2,101,12,0,2,0,95,22,111,6,10,107
18K633,2009,119,110,109,8,0,1,110,7,0,1,0,101,18,108,11,10,109
18K633,2008,103,94,92,5,1,1,87,15,0,0,0,76,27,92,11,8,95
18K635,2017,61,14,13,0,3,1,74,9,1,0,0,20,41,54,7,22,39
18K635,2016,85,23,17,0,3,2,83,8,2,1,0,44,41,71,14,23,62
18K635,2015,96,25,23,0,12,1,49,16,0,1,0,48,48,78,18,18,78
18K635,2014,83,13,13,0,12,1,71,10,1,0,0,37,46,72,11,21,62
18K635,2013,84,17,15,0,18,1,51,5,2,0,0,53,31,75,9,20,64
18K635,2012,74,7,4,0,6,0,52,9,0,0,0,44,30,60,14,17,57
18K635,2011,59,7,7,0,12,0,72,9,2,0,0,33,26,51,8,15,44
18K635,2010,67,7,3,0,14,0,78,2,1,2,1,36,31,53,14,11,56
18K635,2009,83,3,3,0,19,0,71,2,0,0,1,45,38,63,20,11,72
18K635,2008,82,7,5,0,17,0,50,8,0,1,0,46,36,69,13,6,76
18K635,2007,65,10,8,0,11,0,69,11,1,1,0,31,34,47,18,8,57
18K635,2006,101,17,9,0,9,0,56,8,1,0,0,49,52,78,23,12,89
18K635,2005,59,2,2,0,5,0,83,14,4,0,0,28,31,39,20,3,56
18K637,2017,65,63,63,33,0,2,48,5,3,7,0,28,37,50,15,6,59
18K637,2016,73,65,64,6,3,3,49,11,5,5,0,27,46,56,17,10,63
18K637,2015,86,74,70,2,6,5,66,5,9,0,1,35,51,66,20,12,74
18K637,2014,75,61,54,1,8,2,61,8,3,1,0,32,43,66,9,21,54
18K637,2013,72,58,55,1,4,1,61,7,2,0,1,28,44,50,22,10,62
18K637,2012,80,63,59,0,8,3,67,7,2,1,0,28,52,65,15,14,66
18K637,2011,62,48,44,0,6,1,56,5,0,0,0,26,36,50,12,10,52
18K637,2010,61,38,30,0,4,2,55,3,1,0,0,20,41,49,12,17,44
18K637,2009,63,32,32,0,4,1,55,6,1,0,0,32,31,40,23,6,57
18K637,2008,71,37,32,0,9,0,60,9,2,0,0,37,34,51,20,17,54
18K642,2017,48,29,29,6,3,1,35,7,5,0,0,20,28,46,2,8,40
18K642,2016,71,46,43,1,9,1,51,14,5,0,0,27,44,60,11,9,62
18K642,2015,82,50,42,1,13,2,66,6,7,1,0,38,44,65,17,8,74
18K642,2014,80,36,31,0,8,2,71,9,3,1,1,30,50,58,22,19,61
18K642,2013,87,43,39,2,11,1,59,10,3,2,0,23,64,69,18,21,66
18K642,2012,75,47,39,0,4,2,64,7,4,0,0,22,53,59,16,20,55
18K642,2011,77,40,37,0,7,2,70,4,3,0,1,28,49,60,17,7,70
18K642,2010,80,46,44,0,11,2,58,7,2,0,1,35,45,66,14,11,69
18K642,2009,70,37,35,0,6,0,65,11,4,0,0,27,43,59,11,6,64
18K642,2008,86,49,43,0,7,0,75,11,0,0,0,31,55,65,21,10,76
18K673,2017,63,18,18,0,7,2,88,21,0,0,0,23,40,47,16,22,41
18K673,2016,111,32,24,0,12,1,77,17,5,3,0,42,69,88,23,47,64
18K673,2015,92,21,6,0,25,1,71,17,1,0,0,38,54,80,12,33,59
18K673,2014,103,24,12,0,13,1,88,8,3,0,0,48,55,80,23,33,70
18K673,2013,90,27,18,0,7,1,58,12,1,0,0,39,51,67,23,28,62
18K673,2012,100,27,18,0,17,1,58,12,1,0,0,49,51,77,23,26,74
18K673,2011,72,15,13,0,13,1,61,7,0,0,0,33,39,60,12,15,57
18K673,2010,72,15,12,0,10,0,50,12,1,0,0,42,30,56,16,12,60
18K673,2009,79,10,9,0,22,0,70,16,4,2,0,44,35,65,14,8,71
18K673,2008,64,2,2,0,21,0,68,11,0,0,0,39,25,50,14,4,60
18K673,2007,88,9,6,0,12,0,56,8,0,0,0,45,43,64,24,3,85
18K673,2006,69,3,0,0,6,0,76,12,0,0,0,38,31,49,20,10,59
19K404,2017,76,70,70,0,1,1,57,17,2,1,0,46,30,62,14,11,65
19K404,2016,78,70,58,0,4,1,53,16,0,0,0,51,27,62,16,18,60
19K404,2015,70,64,52,0,2,2,88,23,1,0,4,45,25,52,18,10,60
19K404,2014,65,57,42,0,3,1,54,13,1,0,2,40,25,48,17,13,52
19K404,2013,118,98,83,0,3,1,42,21,6,0,0,80,38,91,27,21,97
19K404,2012,71,63,50,0,1,0,56,17,1,2,0,47,24,45,26,10,61
19K404,2011,85,61,49,0,6,0,51,12,1,0,1,63,22,67,18,13,72
19K404,2010,75,53,44,0,8,0,56,25,2,1,1,60,15,54,21,12,63
19K404,2009,70,49,43,0,9,0,47,25,3,0,0,44,26,50,20,12,58
19K404,2008,70,60,60,1,8,0,49,20,1,0,0,54,16,51,19,8,62
19K404,2007,77,63,50,0,1,0,46,29,2,0,0,53,24,60,17,3,74
19K404,2006,78,60,45,0,3,0,24,53,1,0,0,46,32,54,24,6,72
19K409,2017,66,65,60,0,0,1,51,10,0,4,0,34,32,59,7,12,54
19K409,2016,58,53,42,7,2,4,35,18,1,0,0,34,24,45,13,10,48
19K409,2015,59,55,44,1,0,2,41,14,0,0,0,29,30,44,15,14,45
19K409,2014,57,40,36,0,3,3,39,21,0,0,0,25,32,48,9,14,43
19K409,2013,63,56,47,10,0,1,43,23,0,0,0,35,28,49,14,12,51
19K409,2012,58,50,46,1,0,3,54,30,2,2,0,28,30,32,26,4,54
19K409,2011,68,56,55,2,0,1,46,13,0,0,0,34,34,47,21,2,66
19K409,2010,55,42,41,1,0,1,33,17,0,0,0,30,25,47,8,3,52
19K409,2009,61,46,45,2,1,1,35,12,1,0,0,39,22,53,8,2,59
19K409,2008,71,53,52,6,4,0,34,25,0,0,0,41,30,63,8,5,66
19K409,2007,67,56,51,6,3,0,42,15,1,0,0,33,34,54,13,6,61
19K409,2006,91,72,60,6,3,0,44,23,0,1,0,53,38,67,24,13,78
19K409,2005,62,50,45,13,3,0,36,17,0,2,0,37,25,55,7,3,59
19K409,2004,60,49,37,1,0,0,39,20,2,0,0,37,23,41,19,4,56
19K409,2003,51,37,23,0,1,0,48,20,2,1,0,29,22,34,17,2,49
19K409,2002,49,33,0,0,6,0,38,23,1,0,0,28,21,43,6,7,42
19K409,2001,68,44,1,0,6,0,51,15,2,0,0,36,32,66,2,6,62
19K420,2007,332,149,113,5,82,52,179,389,12,0,0,245,249,393,239,47,285
19K420,2006,494,189,129,25,116,58,171,415,15,2,0,321,311,503,158,67,427
19K420,2005,632,215,125,27,121,69,220,480,21,3,0,330,331,639,154,80,552
19K420,2004,661,191,109,20,189,93,250,489,32,4,0,391,402,786,82,102,559
19K420,2003,793,250,130,29,213,65,204,424,40,4,0,426,442,678,59,94,699
19K420,2002,868,300,164,15,224,0,0,1,0,0,0,359,378,0,1,76,792
19K420,2001,737,232,93,17,139,0,0,2,0,0,0,0,1,0,2,99,638
19K422,2017,62,52,52,0,2,2,49,8,2,1,0,29,33,47,15,8,54
19K422,2016,69,65,65,0,0,0,52,15,1,0,1,36,33,55,14,19,50
19K422,2015,65,59,52,0,2,0,44,17,0,0,4,32,33,50,15,16,49
19K435,2003,309,133,0,0,89,3,241,81,2,0,0,148,162,210,99,37,273
19K435,2002,310,100,31,5,87,0,1,3,0,0,0,166,161,251,59,47,280
19K435,2001,327,80,0,0,81,0,0,1,0,0,0,0,1,245,82,1,0
19K502,2017,53,39,39,4,10,1,46,12,0,1,0,6,47,46,7,17,36
19K502,2016,60,47,37,2,2,1,65,24,0,0,0,19,41,46,14,17,43
19K502,2015,54,44,38,3,7,1,35,18,1,1,0,14,40,42,12,13,41
19K502,2014,90,61,54,1,10,1,36,15,1,0,0,24,66,69,21,21,69
19K502,2013,56,39,31,0,9,2,68,20,1,1,0,14,42,42,14,16,40
19K502,2012,53,42,33,0,5,2,69,20,0,0,0,13,40,39,14,19,34
19K502,2011,64,44,37,0,8,1,74,12,0,0,0,15,49,59,5,20,44
19K502,2010,92,59,51,1,12,0,37,13,1,2,0,21,71,79,13,23,69
19K502,2009,89,49,45,0,12,0,38,16,0,0,0,11,78,62,27,17,72
19K502,2008,91,66,57,0,17,0,50,13,1,0,0,18,73,68,23,19,72
19K502,2007,101,60,41,2,26,0,65,23,0,1,0,27,74,69,32,16,85
19K502,2006,87,48,26,4,20,0,87,14,0,0,0,20,67,60,27,15,72
19K502,2005,102,56,16,0,16,0,79,22,1,0,0,35,67,73,29,17,85
19K502,2004,68,34,16,0,7,0,56,11,0,0,1,22,46,51,17,9,59
19K502,2003,6,0,0,0,2,0,5,1,0,0,0,2,4,2,4,1,5
19K504,2017,61,45,45,4,14,1,47,12,0,1,0,23,38,47,14,13,48
19K504,2016,67,50,44,2,9,2,40,23,2,0,0,32,35,48,19,15,52
19K504,2015,67,38,25,1,15,2,64,27,1,2,0,33,34,56,11,23,44
19K504,2014,96,43,30,0,24,1,64,18,1,1,0,34,62,73,23,22,74
19K504,2013,85,47,38,1,17,1,90,27,2,0,0,38,47,58,27,15,70
19K504,2012,78,37,30,1,8,4,87,14,0,2,0,32,46,46,32,20,58
19K504,2011,104,34,31,0,14,2,105,33,1,0,0,51,53,85,19,33,71
19K504,2010,120,45,35,0,24,1,91,27,1,1,0,55,65,87,33,39,81
19K504,2009,107,46,41,1,20,1,64,16,1,1,0,52,55,78,29,14,93
19K504,2008,141,65,58,0,22,0,48,16,1,2,0,60,81,101,40,27,114
19K504,2007,121,76,53,3,15,0,62,16,0,0,0,59,62,74,47,20,101
19K504,2006,111,66,51,5,12,0,76,25,3,0,0,59,52,79,32,15,96
19K504,2005,95,57,42,2,10,0,88,21,1,0,1,45,50,73,22,6,89
19K504,2004,83,35,27,2,15,0,72,21,1,0,1,46,37,62,21,16,67
19K504,2003,14,0,0,0,3,0,11,3,0,0,0,8,6,8,6,4,10
19K504,2002,6,0,0,0,2,0,5,1,0,0,0,2,4,0,6,1,5
19K507,2017,75,65,65,14,8,1,42,28,2,2,0,47,28,69,6,15,60
19K507,2016,103,80,78,4,3,2,59,40,1,1,0,58,45,83,20,21,82
19K507,2015,92,84,67,0,5,1,65,26,0,0,0,60,32,86,6,21,71
19K507,2014,92,74,48,0,5,3,59,29,0,1,0,49,43,84,8,18,74
19K507,2013,97,48,43,0,6,1,82,27,0,0,1,53,44,85,12,23,74
19K507,2012,108,78,68,0,6,1,79,17,1,2,0,69,39,97,11,20,88
19K507,2011,106,61,57,5,6,1,99,21,0,0,0,50,56,89,17,19,87
19K507,2010,111,64,56,5,15,0,78,17,1,0,1,41,70,99,12,23,88
19K507,2009,100,59,53,2,17,0,83,25,0,0,0,61,39,89,11,17,83
19K507,2008,121,75,73,0,26,0,89,17,0,0,0,59,62,89,32,21,100
19K507,2007,105,56,41,1,23,0,77,25,2,1,0,54,51,78,27,20,85
19K507,2006,111,76,57,0,9,0,88,21,0,2,0,65,46,83,28,18,93
19K507,2005,94,66,47,0,5,0,71,19,1,2,1,66,28,73,21,8,86
19K507,2004,76,58,54,3,4,0,64,12,0,0,0,51,25,56,20,5,71
19K507,2003,9,0,0,0,1,0,4,5,0,0,0,4,5,5,4,1,8
19K510,2017,55,39,39,2,13,1,37,12,2,3,0,25,30,50,5,13,42
19K510,2016,61,41,39,1,14,4,41,14,2,0,0,32,29,54,7,12,49
19K510,2015,72,50,43,3,10,2,51,17,0,1,1,48,24,61,11,8,64
19K510,2014,56,41,35,8,5,4,44,7,0,1,0,34,22,50,6,15,41
19K510,2013,66,40,37,2,14,3,44,17,2,0,0,34,32,55,11,17,49
19K510,2012,69,51,44,6,11,1,68,15,2,2,0,38,31,57,12,18,51
19K510,2011,88,53,50,6,9,2,86,14,1,1,0,52,36,72,16,19,69
19K510,2010,106,53,47,0,15,2,80,21,0,0,0,73,33,90,16,17,89
19K510,2009,104,61,56,1,9,1,82,14,0,0,0,62,42,93,11,19,85
19K510,2008,103,62,57,0,14,1,80,14,0,0,0,68,35,81,22,17,86
19K510,2007,97,62,38,0,8,1,64,13,1,0,2,61,36,80,17,22,75
19K510,2006,95,23,6,0,8,3,84,8,2,0,1,57,38,73,22,28,67
19K510,2005,81,51,26,4,9,0,55,12,0,2,0,59,22,65,16,10,71
19K510,2004,98,67,45,8,7,0,93,9,2,2,0,78,20,70,28,8,90
19K510,2003,7,0,0,0,2,0,3,4,0,0,0,3,4,5,2,1,6
19K583,2017,72,62,62,16,6,0,1,71,0,0,0,38,34,68,4,2,70
19K583,2016,67,58,44,1,7,0,2,65,0,0,0,33,34,57,10,0,67
19K583,2015,63,49,37,1,7,0,1,106,0,0,1,33,30,57,6,1,62
19K583,2014,63,47,36,0,10,0,3,103,0,0,0,35,28,56,7,1,62
19K583,2013,50,31,24,0,12,0,0,62,1,0,0,26,24,41,9,0,50
19K583,2012,46,28,23,0,8,0,0,63,0,0,0,21,25,41,5,2,44
19K583,2011,69,33,33,0,26,0,0,49,1,0,0,30,39,61,8,1,68
19K583,2010,100,39,39,0,22,0,0,46,0,0,0,46,54,95,5,2,98
19K583,2009,108,26,26,0,30,0,0,69,0,0,0,53,55,92,16,0,108
19K583,2008,99,31,31,0,13,0,0,100,0,0,0,44,55,93,6,1,98
19K583,2007,106,54,35,0,14,0,0,99,0,0,0,60,46,90,16,2,104
19K615,2017,132,114,113,107,4,6,83,34,2,6,1,20,112,99,33,29,103
19K615,2016,136,105,105,98,5,7,70,52,2,4,1,25,111,101,35,27,109
19K615,2015,170,115,94,2,13,8,107,45,5,3,2,32,138,126,44,43,127
19K615,2014,199,137,122,3,15,3,119,72,4,1,0,22,177,157,42,55,144
19K615,2013,210,134,117,2,20,18,135,48,6,3,0,28,182,153,57,55,155
19K615,2012,246,161,150,1,20,19,142,76,3,5,1,33,213,175,71,49,197
19K615,2011,229,125,116,0,15,14,149,63,3,0,0,33,196,157,72,39,190
19K615,2010,263,136,126,0,26,14,183,60,5,1,0,39,224,190,73,46,217
19K615,2009,275,168,151,12,29,10,195,64,5,1,0,52,223,206,69,46,229
19K615,2008,334,212,200,7,42,11,238,81,3,1,0,63,271,334,0,46,288
19K615,2007,360,274,237,9,14,18,244,92,3,3,0,79,281,358,2,46,314
19K615,2006,346,226,185,60,25,16,241,76,10,3,0,68,278,343,3,41,305
19K615,2005,381,254,195,102,26,20,256,102,1,2,0,85,296,298,83,55,326
19K615,2004,350,214,133,79,32,20,223,102,3,2,0,70,280,283,67,48,302
19K615,2003,331,229,145,52,30,17,218,93,1,2,0,76,255,249,82,40,291
19K615,2002,282,178,120,10,20,12,180,79,10,1,0,60,222,235,47,25,257
19K615,2001,286,199,119,34,14,6,214,58,8,0,0,53,233,269,17,41,245
19K618,2017,107,96,96,27,4,5,39,58,3,1,1,23,84,89,18,20,87
19K618,2016,104,93,81,20,3,8,43,42,4,2,5,13,91,85,19,25,79
19K618,2015,90,83,70,7,3,3,40,44,2,0,1,19,71,77,13,17,73
19K618,2014,95,75,68,7,6,3,37,49,2,2,2,16,79,84,11,24,71
19K618,2013,88,63,54,7,11,7,36,39,4,1,1,21,67,67,21,18,70
19K618,2012,87,62,54,5,4,6,48,31,0,0,2,18,69,72,15,24,63
19K618,2011,114,80,71,8,7,9,54,49,1,0,1,23,91,82,32,22,92
19K618,2010,88,52,48,6,5,7,31,47,2,1,0,32,56,72,16,19,69
19K618,2009,111,49,46,3,9,11,41,56,2,1,0,28,83,89,22,23,88
19K618,2008,103,60,57,3,5,6,37,54,6,0,0,44,59,78,25,16,87
19K639,2017,73,71,71,9,2,14,20,36,3,0,0,35,38,64,9,9,64
19K639,2016,88,76,74,5,6,16,14,50,5,3,0,41,47,77,11,12,76
19K639,2015,75,49,24,0,15,10,19,39,4,2,1,35,40,66,9,19,56
19K639,2014,80,49,34,2,13,9,23,45,2,1,0,34,46,67,13,13,67
19K639,2013,92,49,33,1,17,6,34,50,2,0,0,36,56,76,16,16,76
19K639,2012,81,47,36,3,13,5,31,43,0,1,1,25,56,66,15,21,60
19K639,2011,93,45,32,3,23,6,30,54,1,2,0,30,63,75,18,20,73
19K639,2010,108,53,44,6,13,1,34,71,1,1,0,46,62,84,24,24,84
19K639,2009,91,41,36,0,18,2,32,56,1,0,0,38,53,72,19,19,72
19K639,2008,109,43,41,2,8,0,38,71,0,0,0,49,60,84,25,19,90
19K659,2017,92,84,84,17,3,10,14,66,2,0,0,38,54,84,8,16,76
19K659,2016,65,57,57,16,5,10,11,40,3,1,0,24,41,58,7,7,58
19K659,2015,48,40,29,3,4,7,11,27,2,1,0,22,26,41,7,8,40
19K659,2014,50,43,37,2,5,4,14,30,1,1,0,24,26,44,6,4,46
19K659,2013,63,43,36,3,15,2,14,44,3,0,0,26,37,58,5,15,48
19K659,2012,82,60,52,1,13,5,15,54,7,1,0,36,46,66,16,12,70
19K659,2011,104,57,56,2,20,2,19,83,0,0,0,54,50,87,17,21,83
19K659,2010,102,48,47,10,19,10,13,74,4,1,0,49,53,82,20,10,92
19K659,2009,110,49,47,1,16,10,20,80,0,0,0,58,52,79,31,13,97
19K659,2008,107,53,50,4,15,12,14,79,2,0,0,56,51,69,38,13,94
19K659,2007,113,53,36,4,16,12,18,79,3,1,0,56,57,74,39,10,103
19K659,2006,106,61,40,2,8,17,17,66,5,1,0,64,42,75,31,7,99
19K660,2017,92,72,72,30,7,2,58,25,3,3,1,55,37,84,8,32,60
19K660,2016,104,80,78,12,6,1,75,27,1,0,0,71,33,99,5,35,69
19K660,2015,102,80,73,1,6,4,66,28,1,0,3,73,29,87,15,26,76
19K660,2014,110,82,74,7,13,2,77,31,0,0,0,72,38,100,10,33,77
19K660,2013,136,85,76,6,29,1,92,42,0,0,1,100,36,115,21,39,97
19K660,2012,106,64,63,9,16,1,62,26,1,1,0,73,33,90,16,38,68
19K660,2011,91,48,46,3,14,1,111,42,1,2,0,67,24,80,11,31,60
19K660,2010,70,35,31,1,17,3,166,63,3,4,0,43,27,59,11,23,47
19K660,2009,157,93,83,2,20,3,158,59,4,2,0,105,52,138,19,45,112
19K660,2008,227,138,121,3,39,4,163,68,1,1,0,164,63,227,0,57,170
19K660,2007,239,109,82,7,43,3,140,68,2,0,0,155,84,227,12,53,186
19K660,2006,226,98,50,1,46,6,168,86,3,0,1,152,74,205,21,46,180
19K660,2005,237,95,42,4,46,6,189,72,6,3,0,161,76,183,54,64,173
19K660,2004,213,83,39,8,50,3,165,70,5,0,0,133,80,162,51,43,170
19K660,2003,264,105,7,7,60,0,73,30,2,1,0,177,87,193,71,59,205
19K660,2002,276,98,2,2,69,0,45,24,1,0,0,188,88,201,75,63,213
19K660,2001,243,76,1,0,56,0,175,45,0,7,0,171,72,127,116,60,183
19K683,2017,51,39,39,13,2,5,20,23,1,2,0,24,27,41,10,8,43
19K683,2016,82,66,66,24,5,10,34,30,6,2,0,52,30,73,9,16,66
19K683,2015,73,50,37,2,15,8,39,22,3,0,1,38,35,67,6,18,55
19K683,2014,91,58,46,6,13,12,50,29,0,0,0,59,32,83,8,25,66
19K683,2013,63,40,33,3,6,10,39,13,1,0,0,39,24,51,12,12,51
19K683,2012,74,38,38,4,8,8,43,19,3,0,1,38,36,65,9,15,59
19K683,2011,71,58,51,6,6,5,47,17,1,1,0,46,25,61,10,18,53
19K683,2010,89,63,51,1,5,7,59,21,1,1,0,61,28,75,14,19,70
19K683,2009,77,52,45,0,6,9,31,36,0,1,0,43,34,69,8,10,67
19K683,2008,60,49,49,4,4,8,23,28,1,0,0,30,30,53,7,2,58
19K764,2017,88,78,78,0,5,12,35,30,5,1,5,50,38,72,16,11,77
19K764,2016,73,66,66,0,5,10,33,26,1,2,1,47,26,55,18,7,66
19K764,2015,73,60,45,0,7,17,22,29,1,3,1,51,22,58,15,11,62
19K764,2014,87,68,62,2,7,10,43,25,4,0,5,54,33,66,21,12,75
19K953,2017,62,51,48,0,0,0,44,16,1,1,0,36,26,48,14,5,57
20K445,2017,814,575,575,352,38,340,26,231,210,5,2,347,467,683,131,101,713
20K445,2016,829,608,608,263,60,331,19,264,209,4,2,361,468,678,151,132,697
20K445,2015,873,645,613,262,81,392,23,234,219,2,3,387,486,699,174,125,748
20K445,2014,896,672,623,252,68,390,29,244,223,0,10,382,514,727,169,126,770
20K445,2013,852,658,616,266,53,348,41,228,229,0,6,345,507,653,199,121,731
20K445,2012,730,512,479,181,59,278,19,204,223,0,6,315,415,541,189,117,613
20K445,2011,764,555,517,169,55,282,29,217,235,1,0,327,437,571,193,132,632
20K445,2010,770,521,493,167,89,315,42,180,231,0,2,324,446,560,210,114,656
20K445,2009,816,531,504,161,47,343,31,191,250,0,1,333,483,532,284,110,706
20K445,2008,710,500,477,146,41,244,38,188,239,1,0,287,423,409,301,93,617
20K445,2007,645,448,364,129,41,184,53,203,204,1,0,256,389,365,280,118,527
20K445,2006,621,399,333,149,36,169,48,207,190,1,6,297,324,297,324,77,544
20K445,2005,740,465,382,157,50,201,51,229,248,1,10,347,393,363,377,85,655
20K445,2004,763,452,359,130,71,187,89,211,272,2,2,347,416,314,449,105,658
20K445,2003,713,414,330,111,106,218,60,167,266,1,1,321,392,591,122,91,622
20K445,2002,677,332,265,108,160,189,61,153,274,0,0,331,346,622,55,66,611
20K445,2001,586,312,206,82,134,150,61,118,256,1,0,265,321,524,62,68,518
20K485,2017,303,293,293,217,5,65,13,150,68,0,7,129,174,229,74,50,253
20K485,2016,291,262,262,159,7,71,22,140,49,0,9,118,173,230,61,57,234
20K485,2015,291,257,243,83,12,54,24,139,63,2,9,115,176,218,73,45,246
20K485,2014,314,280,263,114,4,66,30,157,54,0,7,156,158,233,81,51,263
20K485,2013,310,268,246,97,17,47,22,190,46,0,5,132,178,233,77,59,251
20K485,2012,299,246,230,99,9,53,21,176,49,0,0,135,164,228,71,62,237
20K485,2011,343,294,275,116,12,73,26,178,64,2,0,159,184,275,68,72,271
20K485,2010,310,269,253,114,13,60,33,164,52,1,0,159,151,240,70,62,248
20K485,2009,294,244,234,113,18,55,27,161,50,1,0,123,171,232,62,57,237
20K485,2008,297,246,236,114,11,60,27,167,42,1,0,142,155,297,0,43,254
20K485,2007,331,260,244,106,28,63,36,176,52,4,0,148,183,330,1,55,276
20K485,2006,297,225,215,114,18,57,35,151,50,2,2,135,162,295,2,55,242
20K485,2005,279,218,195,128,15,42,41,143,51,2,0,129,150,217,62,36,243
20K485,2004,271,208,183,117,18,60,44,121,46,0,0,112,159,215,56,47,224
20K485,2003,264,198,180,178,25,35,38,140,50,1,0,142,122,189,75,37,227
20K485,2002,256,169,143,71,29,32,40,130,52,2,0,125,131,168,88,42,214
20K485,2001,325,199,159,71,50,27,55,176,67,0,0,156,169,218,107,54,271
20K490,2017,1168,892,892,448,51,369,34,351,399,3,12,556,612,848,320,149,1019
20K490,2016,1115,855,854,379,70,304,38,364,392,0,17,543,572,843,272,151,964
20K490,2015,1111,837,800,300,91,310,49,341,393,4,14,544,567,822,289,144,967
20K490,2014,1119,843,812,315,96,302,52,325,421,2,17,534,585,833,286,127,992
20K490,2013,1094,770,733,323,110,354,47,328,346,1,18,476,618,798,296,148,946
20K490,2012,1066,777,751,276,100,354,43,265,373,2,29,482,584,720,346,115,951
20K490,2011,977,693,670,269,104,320,51,280,324,0,2,474,503,668,309,142,835
20K490,2010,1098,682,656,244,127,318,53,332,392,2,1,499,599,659,439,142,956
20K490,2009,1173,740,718,283,112,387,55,320,409,2,0,524,649,670,503,137,1036
20K490,2008,1023,623,601,228,145,288,31,317,387,0,0,477,546,589,434,114,909
20K490,2007,1144,740,663,236,157,361,56,358,365,1,3,532,612,518,626,119,1025
20K490,2006,986,650,563,208,140,307,39,316,320,2,2,445,541,451,535,79,907
20K490,2005,1044,628,490,185,159,321,45,343,335,0,0,473,571,549,495,99,945
20K490,2004,1123,649,518,188,196,346,70,353,352,2,0,480,643,543,580,117,1006
20K490,2003,1114,591,478,188,201,322,85,320,376,1,10,474,640,558,556,100,1014
20K490,2002,1146,580,426,173,270,369,41,328,407,1,0,537,609,276,870,96,1050
20K490,2001,1089,577,412,180,237,328,37,303,418,3,0,474,615,261,828,122,967
20K505,2017,760,514,514,243,55,282,77,260,134,3,4,317,443,627,133,95,665
20K505,2016,811,542,538,234,90,326,74,276,129,5,1,343,468,691,120,105,706
20K505,2015,826,511,469,92,102,349,64,269,138,1,5,338,488,673,153,84,742
20K505,2014,748,462,422,110,71,292,94,223,135,3,1,336,412,634,114,106,642
20K505,2013,737,452,427,127,92,301,100,204,131,1,0,321,416,586,151,111,626
20K505,2012,771,447,424,125,103,324,58,226,160,3,0,339,432,579,192,121,650
20K505,2011,727,413,401,151,84,355,65,165,136,4,2,311,416,552,175,69,658
20K505,2010,751,396,381,143,117,333,74,200,140,4,0,294,457,593,158,87,664
20K505,2009,842,428,421,172,141,420,48,208,161,1,4,360,482,611,231,71,771
20K505,2008,818,463,435,142,115,356,60,253,145,3,1,356,462,609,209,89,729
20K505,2007,822,453,400,112,181,310,61,289,158,1,3,346,476,582,240,104,718
20K505,2006,859,453,337,147,193,286,92,309,170,0,2,368,491,558,301,106,753
20K505,2005,840,404,326,134,180,306,78,296,146,6,8,376,464,572,268,84,756
20K505,2004,855,411,336,147,225,318,77,292,164,3,1,392,463,512,343,84,771
20K505,2003,816,373,310,139,206,300,55,259,202,0,0,369,447,674,142,93,723
20K505,2002,765,337,269,145,201,318,41,212,191,3,0,344,421,712,53,74,691
20K505,2001,757,272,213,139,228,297,42,187,231,0,0,377,380,687,70,86,671
20K609,2017,87,80,80,63,2,50,7,14,16,0,0,87,0,73,14,13,74
20K609,2016,66,63,63,49,1,34,11,11,10,0,0,66,0,53,13,8,58
20K609,2015,67,62,60,35,1,30,12,11,13,1,0,67,0,65,2,8,59
20K609,2014,84,77,76,35,2,41,13,11,18,0,1,84,0,75,9,15,69
20K609,2013,85,79,79,30,5,46,13,16,9,1,0,85,0,77,8,7,78
20K609,2012,63,59,59,14,2,29,13,12,9,0,0,63,0,57,6,13,50
20K609,2011,67,59,59,8,3,28,11,19,9,0,0,67,0,64,3,8,59
20K609,2010,64,58,56,1,1,29,18,10,7,0,0,64,0,50,14,7,57
21K337,2017,89,60,60,0,11,24,4,38,22,0,1,34,55,83,6,4,85
21K337,2016,83,57,57,0,10,34,1,27,21,0,0,32,51,74,9,1,82
21K337,2015,92,49,47,0,14,28,5,41,17,1,0,36,56,87,5,3,89
21K337,2014,80,52,44,0,13,30,2,25,23,0,0,26,54,75,5,1,79
21K337,2013,100,63,59,0,19,35,11,31,23,0,0,26,74,81,19,3,97
21K337,2012,71,47,46,0,13,25,2,15,29,0,0,24,47,60,11,2,69
21K337,2011,83,62,62,0,6,44,11,13,14,0,1,39,44,77,6,0,83
21K337,2010,84,46,46,0,8,36,8,14,26,0,0,34,50,78,6,2,82
21K337,2009,79,37,37,0,14,29,13,20,16,1,0,35,44,71,8,0,79
21K337,2008,97,42,42,0,20,27,21,27,22,0,0,42,55,97,0,0,97
21K337,2007,62,23,12,0,6,8,27,24,3,0,0,31,31,58,4,3,59
21K337,2006,71,31,11,0,7,10,27,25,9,0,0,29,42,67,4,2,69
21K337,2005,57,54,23,0,3,13,12,19,13,0,0,23,34,48,9,0,57
21K344,2017,151,133,133,28,5,30,19,30,70,1,1,66,85,123,28,25,126
21K344,2016,169,145,145,41,14,26,23,35,78,0,7,76,93,112,57,28,141
21K344,2015,156,114,114,11,14,24,26,30,76,0,0,72,84,106,50,33,123
21K344,2014,158,118,108,14,8,23,33,33,68,1,0,71,87,102,56,29,129
21K344,2013,130,80,78,11,14,7,33,28,58,4,0,63,67,67,63,21,109
21K344,2012,136,101,93,18,9,19,29,28,59,1,0,58,78,62,74,26,110
21K344,2011,150,121,117,1,13,10,35,29,76,0,0,69,81,73,77,33,117
21K344,2010,114,79,72,11,7,18,24,23,49,0,0,48,66,73,41,16,98
21K344,2009,119,90,88,10,5,10,29,32,48,0,0,56,63,119,0,19,100
21K344,2008,99,58,54,8,12,12,22,32,33,0,0,50,49,99,0,15,84
21K344,2007,117,74,72,8,19,20,20,32,45,0,0,65,52,117,0,7,110
21K344,2006,113,71,67,11,8,5,39,27,42,0,0,65,48,113,0,9,104
21K344,2005,92,66,65,17,5,11,37,20,24,0,0,47,45,92,0,6,86
21K348,2017,74,53,53,9,8,9,29,24,11,0,1,18,56,55,19,13,61
21K348,2016,67,48,47,10,1,6,22,26,13,0,0,12,55,43,24,14,53
21K348,2015,50,33,28,2,0,1,33,10,4,2,0,9,41,42,8,11,39
21K348,2014,34,24,21,4,3,3,17,8,5,1,0,2,32,31,3,6,28
21K348,2013,54,32,27,1,3,1,34,10,8,1,0,8,46,41,13,11,43
21K348,2012,62,41,31,4,3,2,42,14,4,0,0,4,58,49,13,14,48
21K348,2011,89,61,58,4,6,3,70,15,1,0,0,13,76,66,23,11,78
21K348,2010,58,46,40,3,2,2,33,17,6,0,0,7,51,41,17,11,47
21K348,2009,66,47,45,7,8,1,41,15,9,0,0,7,59,48,18,10,56
21K348,2008,70,46,45,11,12,3,46,16,5,0,0,11,59,70,0,13,57
21K348,2007,59,38,36,4,15,2,41,15,6,1,0,9,50,56,3,12,47
21K348,2006,65,49,43,13,6,3,43,10,9,0,0,18,47,63,2,7,58
21K348,2005,65,53,44,13,1,0,39,17,3,0,0,15,50,56,9,5,60
21K400,2006,65,31,17,4,19,18,23,13,10,1,0,25,40,53,12,8,57
21K400,2005,212,96,66,22,38,64,75,40,30,2,1,100,112,143,69,31,181
21K400,2004,320,135,84,29,85,65,149,80,24,2,0,174,146,221,99,36,284
21K400,2003,378,131,88,38,115,95,153,85,45,0,0,204,174,304,74,35,343
21K400,2002,446,166,91,20,128,85,185,121,54,1,0,212,234,396,50,52,394
21K400,2001,525,183,88,22,150,107,207,142,69,0,0,250,275,467,58,52,473
21K410,2017,399,341,341,71,31,72,139,103,80,3,2,157,242,326,73,56,343
21K410,2016,474,371,364,40,64,70,168,116,117,2,1,212,262,389,85,62,412
21K410,2015,441,360,336,49,39,79,179,95,83,2,3,171,270,324,117,81,360
21K410,2014,494,349,319,33,53,93,174,114,102,4,7,183,311,387,107,75,419
21K410,2013,484,325,304,59,44,103,146,122,110,1,2,213,271,356,128,70,414
21K410,2012,495,295,281,46,56,78,169,117,122,3,6,172,323,321,174,69,426
21K410,2011,586,345,328,65,56,98,212,142,130,3,1,260,326,366,220,82,504
21K410,2010,637,409,388,78,43,120,202,129,183,3,0,284,353,413,224,76,561
21K410,2009,633,394,380,69,91,128,200,115,187,2,1,282,351,450,183,71,562
21K410,2008,700,441,425,100,106,139,219,145,193,4,0,310,390,383,317,79,621
21K410,2007,716,418,353,76,143,116,255,157,178,9,1,289,427,399,317,93,623
21K410,2006,620,354,280,74,99,97,231,125,163,3,1,286,334,327,293,73,547
21K410,2005,639,369,297,112,77,109,223,130,171,2,4,267,372,344,295,82,557
21K410,2004,610,275,217,77,149,87,233,127,156,3,4,238,372,331,279,73,537
21K410,2003,572,315,231,1,104,71,189,105,204,2,1,266,306,475,97,49,523
21K410,2002,564,264,209,14,112,80,152,111,219,2,0,273,291,517,47,34,530
21K410,2001,591,295,209,105,103,72,183,114,219,3,0,274,317,537,54,56,535
21K468,2017,91,91,91,58,0,5,31,28,26,0,1,38,53,46,45,17,74
21K468,2016,85,84,82,37,0,6,22,17,35,1,4,39,46,58,27,14,71
21K468,2015,85,80,79,21,0,5,15,25,40,0,0,42,43,66,19,17,68
21K468,2014,88,88,88,37,0,3,15,23,46,0,1,44,44,54,34,17,71
21K468,2013,80,76,74,22,0,7,17,24,32,0,0,34,46,62,18,12,68
21K468,2012,81,77,74,11,1,6,26,12,37,0,0,34,47,59,22,9,72
21K468,2011,79,74,71,17,1,6,24,19,29,1,0,34,45,56,23,8,71
21K468,2010,75,68,65,15,0,3,13,19,40,0,0,32,43,58,17,10,65
21K468,2009,69,63,62,9,1,5,26,13,25,0,0,36,33,61,8,4,65
21K525,2017,867,702,701,342,22,223,178,156,264,4,42,473,394,573,294,146,721
21K525,2016,854,703,692,328,19,229,181,175,244,2,23,525,329,578,276,149,705
21K525,2015,888,691,662,246,28,227,200,169,265,4,23,524,364,595,293,148,740
21K525,2014,939,737,714,273,21,239,210,212,245,4,29,562,377,670,269,155,784
21K525,2013,909,680,657,207,25,234,193,205,246,0,31,517,392,643,266,144,765
21K525,2012,912,713,691,200,22,258,198,176,273,2,5,566,346,498,414,140,772
21K525,2011,970,767,747,212,31,294,217,196,255,2,6,545,425,601,369,153,817
21K525,2010,960,738,717,224,35,255,231,173,298,1,2,557,403,467,493,130,830
21K525,2009,937,678,661,265,49,253,203,156,322,3,0,558,379,462,475,109,828
21K525,2008,892,680,661,312,53,263,213,121,293,2,0,519,373,387,505,99,793
21K525,2007,987,710,675,289,75,244,247,160,336,0,0,583,404,981,6,141,846
21K525,2006,938,702,663,308,55,266,253,138,278,2,1,532,406,928,10,111,827
21K525,2005,879,611,571,292,61,254,221,123,280,1,0,568,311,847,32,75,804
21K525,2004,897,654,608,371,87,226,214,141,316,0,0,548,349,334,563,86,811
21K525,2003,909,596,551,293,100,190,260,124,329,4,2,542,367,327,582,99,810
21K525,2002,872,604,566,295,83,179,213,110,370,0,0,554,318,218,654,44,828
21K525,2001,897,608,544,279,105,165,210,108,410,4,0,531,366,183,714,74,823
21K540,2017,558,409,408,179,23,178,155,133,79,3,10,285,273,467,91,58,500
21K540,2016,562,428,419,123,31,176,167,129,82,3,5,273,289,447,115,72,490
21K540,2015,609,453,415,106,53,208,181,126,80,7,7,293,316,499,110,69,540
21K540,2014,576,460,438,109,40,184,196,113,66,4,13,285,291,467,109,70,506
21K540,2013,402,305,286,54,23,115,133,92,59,2,1,185,217,321,81,47,355
21K540,2012,443,304,296,97,21,188,97,76,80,2,0,195,248,373,70,57,386
21K540,2011,363,231,221,82,9,176,79,58,49,1,0,163,200,314,49,36,327
21K540,2010,552,408,393,112,17,227,147,113,62,3,0,255,297,475,77,59,493
21K540,2009,597,418,404,97,27,238,178,96,84,1,0,296,301,492,105,54,543
21K540,2008,635,422,410,121,60,244,197,121,70,3,0,336,299,425,210,59,576
21K540,2007,733,452,415,101,91,272,186,153,116,6,0,362,371,469,264,71,662
21K540,2006,603,347,296,70,76,204,190,123,81,3,2,329,274,357,246,67,536
21K540,2005,637,355,305,121,67,239,186,117,92,1,2,349,288,294,343,71,566
21K540,2004,705,361,323,148,85,235,202,119,146,2,1,363,342,293,412,75,630
21K540,2003,729,389,337,162,104,235,228,122,142,2,0,394,335,555,174,76,653
21K540,2002,755,395,340,155,127,224,215,129,183,4,0,397,358,676,79,44,711
21K540,2001,679,385,291,161,106,169,227,126,152,5,0,385,294,614,65,59,620
21K559,2017,59,57,57,21,2,4,24,26,5,0,0,34,25,44,15,10,49
21K559,2016,72,55,55,12,7,13,14,29,12,3,1,34,38,57,15,15,57
21K559,2015,65,60,51,7,0,12,20,24,9,0,0,40,25,48,17,10,55
21K559,2014,63,54,49,1,1,6,31,13,12,0,1,24,39,41,22,17,46
21K559,2013,63,56,51,2,5,4,36,19,4,0,0,33,30,50,13,17,46
21K559,2012,75,71,71,0,0,2,37,22,13,1,0,53,22,66,9,15,60
21K559,2011,57,53,53,0,2,5,33,12,7,0,0,31,26,52,5,14,43
21K559,2010,63,58,57,0,2,4,27,15,17,0,0,33,30,52,11,10,53
21K559,2009,45,40,34,0,2,2,20,24,11,1,0,24,21,36,9,7,38
21K559,2008,58,35,32,0,6,0,26,11,8,0,0,27,31,58,0,12,46
21K559,2007,37,29,24,1,4,0,19,14,4,0,0,18,19,37,0,2,35
21K572,2017,88,80,80,0,2,7,13,36,28,0,4,42,46,66,22,27,61
21K572,2016,92,81,81,0,4,22,12,34,21,2,1,47,45,74,18,18,74
21K572,2015,82,66,65,0,1,15,15,26,21,3,2,37,45,60,22,13,69
21K572,2014,71,61,61,0,0,13,13,24,20,1,0,35,36,56,15,14,57
21K572,2013,69,57,55,0,2,14,12,28,13,2,0,32,37,58,11,12,57
21K572,2012,65,60,60,0,3,12,10,24,15,0,4,28,37,51,14,5,60
21K572,2011,67,53,51,0,8,7,13,33,14,0,0,33,34,50,17,11,56
21K572,2010,67,54,52,0,4,15,10,28,14,0,0,32,35,53,14,10,57
21K572,2009,52,39,38,0,6,12,11,22,7,0,0,33,19,41,11,9,43
21K572,2008,50,28,27,0,9,10,7,22,11,0,0,20,30,50,0,8,42
21K572,2007,35,13,11,0,9,3,11,17,4,0,0,17,18,34,1,10,25
21K620,2017,91,62,62,20,3,2,51,26,11,0,1,22,69,84,7,29,62
21K620,2016,102,67,65,14,16,2,55,27,15,2,1,21,81,97,5,47,55
21K620,2015,83,60,40,5,15,3,54,13,10,0,3,17,66,70,13,36,47
21K620,2014,144,92,74,4,16,11,96,26,9,1,1,36,108,122,22,46,98
21K620,2013,123,83,66,1,13,6,80,24,12,0,1,29,94,104,19,47,76
21K620,2012,97,43,33,1,17,3,66,20,8,0,0,19,78,81,16,34,63
21K620,2011,119,68,62,2,14,2,97,14,6,0,0,41,78,109,10,31,88
21K620,2010,190,96,85,4,32,6,132,32,20,0,0,38,152,162,28,55,135
21K620,2009,264,144,131,11,39,7,192,43,21,1,0,63,201,219,45,52,212
21K620,2008,293,183,173,9,52,14,221,43,15,0,0,55,238,243,50,57,236
21K620,2007,282,130,115,5,59,3,213,52,10,4,0,55,227,222,60,57,225
21K620,2006,281,119,94,2,60,6,206,59,8,2,0,41,240,217,64,62,219
21K620,2005,263,115,86,4,39,7,204,33,19,0,0,52,211,181,82,45,218
21K620,2004,276,128,90,15,50,8,190,58,19,1,0,58,218,205,71,57,219
21K620,2003,284,119,75,17,51,14,203,55,12,0,0,69,215,218,66,64,220
21K620,2002,279,113,56,8,64,4,197,62,15,1,0,47,232,239,40,47,232
21K620,2001,324,123,73,15,65,5,237,58,23,1,0,79,245,306,18,68,256
21K690,2017,159,133,133,70,3,38,5,45,70,0,1,73,86,99,60,34,125
21K690,2016,137,124,124,42,4,28,3,31,70,0,5,76,61,102,35,26,111
21K690,2015,173,133,117,26,11,37,9,47,79,1,0,80,93,130,43,27,146
21K690,2014,164,129,114,25,13,30,4,46,83,1,0,86,78,117,47,35,129
21K690,2013,157,129,120,22,9,25,5,45,80,2,0,66,91,116,41,32,125
21K690,2012,159,121,114,18,9,28,8,27,96,0,0,81,78,101,58,19,140
21K690,2011,151,108,103,19,6,21,7,26,97,0,0,78,73,96,55,23,128
21K690,2010,166,127,121,23,8,14,12,31,109,0,0,74,92,109,57,23,143
21K690,2009,153,97,87,13,16,14,11,45,83,0,0,85,68,77,76,29,124
21K690,2008,172,117,106,26,23,15,12,45,100,0,0,87,85,75,97,37,135
21K690,2007,177,117,103,28,18,12,19,39,107,0,0,100,77,81,96,34,143
21K690,2006,140,95,79,26,21,9,20,22,88,1,0,77,63,137,3,34,106
21K690,2005,134,81,70,20,15,6,19,22,87,0,0,64,70,133,1,34,100
21K690,2004,150,85,66,29,22,11,19,23,97,0,0,69,81,150,0,42,108
21K690,2003,146,87,67,25,25,13,24,24,85,0,0,74,72,146,0,46,100
21K690,2002,124,75,55,18,12,9,10,22,83,0,0,58,66,121,3,34,90
21K690,2001,132,81,66,21,28,10,13,18,91,0,0,78,54,118,14,23,109
21K728,2017,76,16,16,0,14,3,26,36,10,0,1,41,35,67,9,24,52
21K728,2016,80,12,11,0,3,4,34,33,7,0,2,34,46,74,6,26,54
21K728,2015,91,13,3,0,21,2,43,31,15,0,0,47,44,72,19,44,47
21K728,2014,64,18,8,0,7,4,34,26,10,0,0,28,36,55,9,25,39
21K728,2013,74,11,8,0,18,1,38,19,11,0,0,33,41,58,16,14,60
21K728,2012,69,9,9,0,17,1,36,22,15,0,0,29,40,57,12,9,60
21K728,2011,74,9,9,0,20,3,27,17,21,0,0,39,35,58,16,10,64
21K728,2010,68,8,8,0,16,3,40,31,17,0,0,37,31,53,15,5,63
21K728,2009,91,14,10,0,30,2,38,34,12,1,0,43,48,79,12,8,83
21K728,2008,87,16,14,0,21,2,41,34,20,0,0,54,33,74,13,6,81
21K728,2007,97,23,16,0,20,5,26,17,17,0,0,60,37,87,10,10,87
21K728,2006,65,17,7,0,8,3,36,19,13,0,0,28,37,55,10,5,60
21K728,2005,71,26,13,0,3,4,27,13,6,0,0,35,36,56,15,7,64
21K728,2004,50,2,1,0,0,1,10,3,4,0,0,23,27,37,13,7,43
21K728,2003,18,0,0,0,0,0,31,29,4,0,0,7,11,14,4,3,15
21K728,2002,6,0,0,0,0,0,1,5,0,0,0,2,4,5,1,2,4
22K405,2017,994,933,933,729,3,354,277,137,201,1,24,581,413,752,242,126,868
22K405,2016,992,949,949,709,11,345,273,117,233,0,24,574,418,760,232,101,891
22K405,2015,1000,914,885,604,19,390,268,105,220,0,17,560,440,768,232,82,918
22K405,2014,846,759,750,513,19,323,184,110,214,4,11,478,368,612,234,51,795
22K405,2013,931,818,795,508,22,340,273,104,213,0,1,521,410,626,305,52,879
22K405,2012,1065,937,915,569,16,342,353,140,226,1,3,596,469,508,557,71,994
22K405,2011,807,723,716,449,16,266,256,83,200,0,2,461,346,390,417,35,772
22K405,2010,913,786,781,505,21,322,260,110,216,0,5,527,386,393,520,33,880
22K405,2009,985,793,773,444,32,307,371,120,186,1,0,519,466,443,542,59,926
22K405,2008,972,783,774,450,54,315,350,111,196,0,0,528,444,373,599,49,923
22K405,2007,932,772,742,484,33,269,353,99,211,0,0,514,418,390,542,52,880
22K405,2006,872,757,709,492,14,303,280,79,210,0,0,502,370,218,654,28,844
22K405,2005,793,652,583,368,23,198,311,71,210,3,0,438,355,138,655,31,762
22K405,2004,939,746,678,459,48,239,374,89,234,2,1,534,405,171,768,35,904
22K405,2003,941,734,669,473,48,214,398,80,243,1,5,522,419,257,684,54,887
22K405,2002,750,619,585,383,17,176,268,51,255,0,0,417,333,107,643,26,724
22K405,2001,869,681,610,430,39,176,314,86,288,5,0,489,380,127,742,57,812
22K425,2017,994,862,862,596,29,206,140,163,473,9,3,433,561,762,232,133,861
22K425,2016,849,740,739,372,53,140,161,154,390,2,2,354,495,634,215,120,729
22K425,2015,878,678,651,222,63,198,141,155,383,1,0,374,504,661,217,122,756
22K425,2014,819,656,617,229,48,165,125,152,367,6,4,358,461,616,203,111,708
22K425,2013,753,596,564,195,53,144,145,114,349,1,0,314,439,557,196,97,656
22K425,2012,754,582,556,194,68,161,126,131,333,3,0,309,445,553,201,88,666
22K425,2011,714,550,526,195,57,183,109,101,318,3,0,312,402,444,270,94,620
22K425,2010,797,569,542,212,78,184,121,92,398,2,0,361,436,475,322,87,710
22K425,2009,824,564,546,214,102,150,165,133,376,0,0,368,456,518,306,90,734
22K425,2008,780,518,499,196,95,162,125,113,379,1,0,383,397,556,224,99,681
22K425,2007,726,478,438,164,86,120,125,106,374,1,0,338,388,424,302,90,636
22K425,2006,1076,713,639,245,149,168,340,162,403,3,0,496,580,518,558,96,980
22K425,2005,925,609,526,227,127,171,189,130,433,2,0,411,514,371,554,80,845
22K425,2004,1062,701,548,239,149,160,321,141,440,0,0,482,580,250,812,118,944
22K425,2003,1019,652,545,262,175,158,191,117,548,4,1,458,561,323,696,81,938
22K425,2002,1018,647,585,269,158,163,165,94,593,3,0,478,540,250,768,58,960
22K425,2001,942,592,512,271,187,142,151,90,559,0,0,433,509,190,752,81,861
22K495,2012,167,108,96,0,25,21,80,40,25,1,0,70,97,103,64,43,124
22K495,2011,270,136,132,10,41,36,151,42,41,0,0,113,157,173,97,39,231
22K495,2010,448,196,188,11,89,60,264,73,49,1,1,196,252,275,173,51,397
22K495,2009,521,198,186,12,83,67,311,88,53,0,2,225,296,305,216,48,473
22K495,2008,621,283,272,25,127,83,371,102,64,0,1,315,306,300,321,77,544
22K495,2007,619,351,290,35,130,70,392,102,55,0,0,320,299,299,320,76,543
22K495,2006,537,311,208,49,117,64,343,84,43,1,2,269,268,245,292,77,460
22K495,2005,670,354,182,33,134,74,423,102,59,2,10,321,349,232,438,88,582
22K495,2004,755,375,196,37,139,68,499,95,82,6,5,377,378,255,500,87,668
22K495,2003,771,371,214,66,124,98,465,108,93,3,4,396,375,271,500,77,694
22K495,2002,808,386,236,65,90,97,516,101,94,0,0,418,390,221,587,61,747
22K495,2001,656,302,156,67,100,101,376,62,116,1,0,348,308,151,505,63,593
22K535,2017,240,222,222,196,1,60,10,25,142,1,2,134,106,115,125,43,197
22K535,2016,262,251,251,211,5,66,25,33,135,2,1,134,128,134,128,43,219
22K535,2015,235,225,216,178,1,66,15,14,139,1,0,129,106,120,115,33,202
22K535,2014,265,245,240,199,0,53,30,23,157,2,0,139,126,117,148,33,232
22K535,2013,271,255,246,199,2,68,29,23,149,0,2,158,113,144,127,37,234
22K535,2012,265,252,251,166,2,44,21,32,165,0,3,154,111,109,156,34,231
22K535,2011,252,238,235,167,0,34,25,30,157,2,4,140,112,103,149,21,231
22K535,2010,240,220,218,148,1,37,13,22,167,1,0,139,101,96,144,28,212
22K535,2009,247,231,228,155,0,32,29,34,150,1,1,143,104,101,146,15,232
22K535,2008,267,259,258,185,2,34,27,22,184,0,0,171,96,96,171,15,252
22K535,2007,262,251,246,176,5,27,31,18,186,0,0,149,113,101,161,14,248
22K535,2006,253,244,240,195,6,28,22,18,184,0,1,155,98,61,192,11,242
22K535,2005,213,180,161,107,5,36,56,20,101,0,0,97,116,78,135,19,194
22K535,2004,259,217,194,110,13,30,62,24,142,1,0,138,121,44,215,18,241
22K535,2003,204,169,144,3,9,18,25,20,115,0,26,104,100,40,164,22,182
22K535,2002,190,150,76,0,9,13,30,17,130,0,0,87,103,17,173,14,176
22K535,2001,172,127,78,0,11,13,16,15,128,0,0,90,82,19,153,8,164
22K555,2017,153,149,149,105,3,19,111,16,5,1,1,84,69,105,48,21,132
22K555,2016,151,148,141,83,0,16,114,12,8,1,0,111,40,99,52,12,139
22K555,2015,155,154,147,76,0,10,100,20,8,0,17,101,54,105,50,13,142
22K555,2014,142,141,129,55,0,10,93,20,5,1,13,94,48,94,48,15,127
22K555,2013,145,141,140,49,0,14,99,14,12,2,4,90,55,98,47,7,138
22K555,2012,147,141,141,49,0,10,103,12,5,2,15,98,49,100,47,8,139
22K555,2011,154,150,150,68,0,14,123,10,6,0,1,93,61,107,47,2,152
22K555,2010,136,136,134,63,0,14,101,18,1,2,0,90,46,84,52,6,130
22K555,2008,131,120,118,35,4,6,121,18,4,1,0,104,46,74,76,6,125
22K555,2007,150,148,134,38,0,3,101,13,3,0,0,76,44,75,45,3,147
22K555,2006,120,115,108,25,0,3,105,11,3,1,1,85,39,69,55,0,120
22K555,2005,124,118,104,19,0,1,104,10,4,0,1,82,38,26,94,3,121
22K555,2004,120,113,90,23,1,2,122,9,5,0,0,91,47,33,105,1,119
22K555,2003,138,119,100,28,2,3,96,15,11,0,0,87,38,21,104,5,133
22K555,2002,125,108,87,28,4,0,2,0,0,0,0,75,46,21,100,2,123
22K555,2001,121,102,69,19,2,0,97,7,16,1,0,0,2,0,2,4,117
22K585,2003,10,5,0,0,1,0,1,0,0,0,0,33,43,60,90,2,8
22K585,2002,76,6,1,0,5,0,1,0,0,0,0,82,68,0,1,7,69
22K585,2001,150,5,0,0,7,0,7,3,0,0,0,0,1,0,1,7,143
22K611,2017,83,75,74,0,2,14,25,5,38,1,0,33,50,62,21,7,76
22K611,2016,116,98,97,0,3,22,38,21,33,0,2,63,53,105,11,10,106
22K611,2015,119,85,69,0,6,14,37,32,35,1,0,63,56,97,22,20,99
22K611,2014,109,86,75,0,3,15,44,24,24,2,0,55,54,83,26,18,91
22K611,2013,94,70,63,1,3,17,30,20,26,1,0,53,41,74,20,12,82
22K630,2017,90,13,13,0,9,7,26,27,30,0,0,34,56,72,18,22,68
22K630,2016,89,19,17,0,2,10,18,35,26,0,0,41,48,70,19,22,67
22K630,2015,93,19,15,0,16,7,24,29,31,1,1,42,51,71,22,17,76
22K630,2014,96,12,8,0,11,10,27,28,30,0,1,45,51,80,16,22,74
22K630,2013,100,21,17,0,16,8,40,24,28,0,0,39,61,82,18,14,86
22K630,2012,102,20,18,0,15,6,22,34,37,3,0,43,59,81,21,15,87
22K630,2011,93,19,17,0,5,13,32,25,22,1,0,43,50,77,16,17,76
22K630,2010,43,6,5,0,1,5,16,15,7,0,0,18,25,34,9,6,37
23K493,2017,72,64,64,2,4,1,59,10,0,2,0,28,44,55,17,19,53
23K493,2016,82,67,61,8,5,2,70,8,1,1,0,41,41,65,17,15,67
23K493,2015,61,42,33,1,6,1,51,7,1,1,0,26,35,55,6,16,45
23K493,2014,70,56,49,3,1,1,62,6,0,1,0,25,45,66,4,18,52
23K493,2013,79,47,44,0,9,2,74,10,0,0,0,29,50,73,6,20,59
23K493,2012,86,58,55,1,7,1,78,6,1,1,0,38,48,79,7,18,68
23K493,2011,87,49,44,2,5,3,73,9,1,2,0,32,55,74,13,14,73
23K493,2010,86,46,40,2,3,1,63,8,0,1,0,43,43,67,19,17,69
23K493,2009,88,48,45,5,11,2,91,11,0,1,0,47,41,67,21,16,72
23K493,2008,73,44,44,8,7,1,60,8,0,0,1,37,36,63,10,8,65
23K493,2007,105,64,57,13,9,1,53,6,2,0,0,50,55,81,24,17,88
23K493,2006,70,44,30,3,5,0,71,8,0,0,0,36,34,59,11,13,57
23K493,2005,62,42,26,1,1,0,79,6,0,1,0,37,25,46,16,4,58
23K493,2004,65,50,22,3,1,0,56,9,0,0,0,42,23,53,12,4,61
23K514,2017,26,26,26,0,0,1,23,2,0,1,0,13,13,23,3,5,21
23K514,2016,27,23,23,0,4,1,30,4,0,1,0,17,10,21,6,2,25
23K514,2015,36,28,24,0,3,1,49,12,0,0,0,17,19,33,3,11,25
23K514,2014,62,30,20,0,12,1,80,11,0,0,0,22,40,57,5,21,41
23K514,2013,82,54,44,2,18,2,84,5,1,0,0,36,46,76,6,24,58
23K514,2012,72,40,36,0,15,0,21,4,0,1,0,31,41,58,14,11,61
23K514,2011,80,44,40,3,8,0,72,8,1,1,0,43,37,61,19,17,63
23K514,2010,92,46,42,4,7,0,60,11,1,0,0,45,47,77,15,18,74
23K514,2009,82,44,41,4,12,0,70,10,0,0,0,42,40,63,19,15,67
23K514,2008,79,42,39,6,8,0,76,6,0,0,0,38,41,79,0,16,63
23K514,2007,92,56,47,9,8,0,71,8,0,0,0,51,41,92,0,19,73
23K514,2006,92,65,45,8,6,0,83,7,2,0,0,55,37,92,0,13,79
23K514,2005,93,72,48,13,1,0,83,9,1,0,0,54,39,76,17,7,86
23K514,2004,98,66,48,12,3,0,83,13,2,0,0,59,39,79,19,9,89
23K643,2017,64,15,15,0,6,2,66,11,0,2,0,19,45,57,7,23,41
23K643,2016,87,20,18,0,10,2,44,15,0,2,0,37,50,76,11,22,65
23K643,2015,81,16,8,0,16,1,64,10,0,2,0,40,41,64,17,29,52
23K643,2014,63,4,4,0,11,2,60,10,0,0,0,26,37,51,12,14,49
23K643,2013,77,12,11,0,4,1,52,11,1,0,0,34,43,54,23,18,59
23K643,2012,72,7,4,0,8,2,75,9,0,0,0,33,39,57,15,15,57
23K643,2011,65,9,5,0,14,1,50,4,0,1,0,37,28,50,15,16,49
23K643,2010,61,10,7,0,9,0,50,10,1,3,0,29,32,45,16,9,52
23K643,2009,86,12,11,0,18,0,69,15,2,1,0,52,34,64,22,13,73
23K643,2008,68,7,5,0,13,0,54,7,0,0,0,40,28,41,27,11,57
23K643,2007,89,12,5,0,16,0,59,8,1,0,0,54,35,65,24,13,76
23K643,2006,97,26,12,0,11,0,71,16,1,1,0,58,39,52,45,8,89
23K643,2005,56,3,3,0,4,0,85,9,2,1,0,23,33,33,23,3,53
23K644,2017,80,75,75,17,0,1,70,8,1,0,0,0,80,52,28,19,61
23K644,2016,97,84,82,10,3,1,91,4,0,0,1,0,97,71,26,19,78
23K644,2015,80,70,60,7,3,1,70,8,0,1,0,0,80,57,23,14,66
23K644,2014,90,79,66,2,2,0,78,12,0,0,0,0,90,73,17,24,66
23K644,2013,72,47,43,4,0,0,63,5,2,0,2,0,72,51,21,13,59
23K644,2012,71,52,48,2,0,0,63,6,1,0,1,0,71,45,26,12,59
23K644,2011,58,53,46,3,1,0,46,11,1,0,0,0,58,39,19,10,48
23K645,2007,73,46,33,0,8,2,40,28,1,2,0,41,32,53,20,12,61
23K645,2006,93,52,33,1,14,1,59,46,0,0,0,51,42,65,28,19,74
23K645,2005,101,48,25,1,24,1,59,46,0,0,0,58,43,63,38,14,87
23K645,2004,106,55,24,2,21,0,53,37,1,0,2,54,52,57,49,19,87
23K645,2003,106,51,19,1,13,0,56,44,1,0,0,57,49,81,25,12,94
23K645,2002,92,38,8,0,12,0,61,29,1,1,0,46,46,49,43,15,77
23K645,2001,102,43,11,0,12,0,57,41,4,0,0,61,41,41,61,10,92
23K647,2017,112,20,19,0,12,2,78,27,2,2,1,47,65,99,13,29,83
23K647,2016,108,16,14,0,23,2,80,22,3,1,0,55,53,94,14,36,72
23K647,2015,89,10,9,0,27,1,74,12,1,0,1,38,51,84,5,34,55
23K647,2014,93,22,17,0,15,1,58,11,1,1,0,43,50,84,9,29,64
23K647,2013,73,16,16,0,10,1,90,16,0,1,0,34,39,65,8,17,56
23K647,2012,77,16,13,0,9,1,76,14,0,0,0,42,35,65,12,12,65
23K647,2011,72,15,12,0,6,0,79,11,0,1,2,45,27,66,6,9,63
23K647,2010,79,23,20,0,6,0,67,6,0,0,0,51,28,67,12,3,76
23K647,2009,88,20,17,0,17,0,61,13,1,2,0,51,37,77,11,8,80
23K647,2008,108,23,19,0,24,0,64,14,1,0,0,58,50,97,11,9,99
23K647,2007,91,27,18,0,18,0,79,8,1,0,0,58,33,68,23,9,82
23K647,2006,97,22,11,0,16,0,83,13,0,1,0,58,39,71,26,12,85
23K647,2005,55,6,5,0,2,0,47,7,1,0,0,31,24,39,16,3,52
23K697,2017,41,30,30,0,2,1,26,13,1,0,0,19,22,40,1,23,18
23K697,2016,46,28,28,0,3,3,33,6,4,0,0,20,26,38,8,14,32
23K697,2015,64,45,34,2,9,1,45,12,0,0,0,38,26,59,5,24,40
23K697,2014,58,40,33,4,0,2,83,10,0,0,0,35,23,49,9,21,37
23K697,2013,65,42,40,2,7,1,82,15,1,0,0,46,19,53,12,18,47
23K697,2012,91,59,57,9,9,0,49,14,0,1,0,57,34,69,22,19,72
23K697,2011,83,51,49,7,9,0,49,14,1,0,1,59,24,63,20,16,67
23K697,2010,95,61,60,15,12,0,78,13,0,0,0,59,36,73,22,14,81
23K697,2009,95,61,57,12,5,0,74,8,1,0,0,64,31,76,19,14,81
23K697,2008,98,73,67,16,7,0,80,14,1,0,0,68,30,98,0,17,81
23K697,2007,91,60,58,16,3,0,83,12,1,1,1,61,30,91,0,15,76
23K697,2006,99,72,60,16,3,0,80,10,0,1,0,55,44,97,2,23,76
23K697,2005,121,89,71,19,5,0,108,13,0,0,0,74,47,91,30,14,107
23K697,2004,94,76,52,12,4,0,82,10,1,1,0,65,29,72,22,11,83
23K697,2003,78,56,28,9,10,0,71,7,0,0,0,54,24,60,18,16,62
23K697,2002,70,54,45,10,2,0,58,12,0,0,0,41,29,53,17,0,70
24Q236,2017,70,54,54,0,5,10,2,57,1,0,0,38,32,64,6,1,69
24Q236,2016,62,46,46,0,5,25,3,28,6,0,0,26,36,55,7,6,56
24Q236,2015,75,50,46,0,11,19,3,45,7,1,0,39,36,66,9,3,72
24Q236,2014,90,49,48,0,23,15,4,62,8,1,0,55,35,78,12,0,90
24Q236,2013,70,41,40,0,13,17,4,44,5,0,0,25,45,54,16,0,70
24Q264,2017,190,183,183,109,0,58,4,89,29,1,9,87,103,154,36,18,172
24Q264,2016,157,153,153,107,0,30,5,95,21,1,5,92,65,134,23,21,136
24Q264,2015,148,140,140,81,2,39,9,73,22,3,2,84,64,109,39,15,133
24Q264,2014,128,120,120,64,0,39,7,58,21,3,0,64,64,103,25,12,116
24Q264,2013,140,130,130,78,0,24,11,76,26,2,1,75,65,113,27,13,127
24Q264,2012,124,113,113,61,2,25,16,69,13,1,0,66,58,97,27,12,112
24Q264,2011,123,114,114,74,0,25,6,73,18,0,1,60,63,106,17,12,111
24Q264,2010,115,105,105,52,1,20,10,69,14,2,0,62,53,89,26,12,103
24Q264,2009,109,95,95,53,2,17,13,60,18,1,0,46,63,84,25,10,99
24Q264,2008,103,94,94,61,3,21,9,53,20,0,0,52,51,75,28,9,94
24Q264,2007,117,101,98,58,2,14,10,78,15,0,0,73,44,92,25,9,108
24Q264,2006,90,81,79,45,2,19,10,43,18,0,0,49,41,64,26,8,82
24Q264,2005,84,73,70,27,2,20,14,40,10,0,0,45,39,66,18,6,78
24Q267,2017,83,82,82,63,1,7,7,53,13,0,3,41,42,63,20,17,66
24Q267,2016,96,83,83,12,5,9,10,61,15,0,1,50,46,77,19,19,77
24Q267,2015,81,77,74,14,1,19,2,48,11,0,1,47,34,57,24,17,64
24Q267,2014,99,80,77,11,3,13,14,52,15,0,5,61,38,76,23,14,85
24Q267,2013,81,65,60,18,1,11,6,48,13,1,2,49,32,64,17,11,70
24Q267,2012,108,86,84,28,3,20,15,63,4,1,5,65,43,85,23,17,91
24Q267,2011,101,83,83,25,8,21,15,53,12,0,0,54,47,79,22,13,88
24Q267,2010,100,66,61,13,8,11,16,59,14,0,0,57,43,71,29,15,85
24Q267,2009,86,64,56,17,4,14,10,48,14,0,0,50,36,54,32,17,69
24Q267,2008,63,46,44,5,4,4,6,37,16,0,0,40,23,44,19,9,54
24Q267,2007,95,63,52,6,4,11,3,60,21,0,0,62,33,72,23,11,84
24Q267,2006,101,81,68,15,3,12,14,56,18,0,1,54,47,83,18,12,89
24Q267,2005,113,88,56,17,2,18,19,52,23,1,0,63,50,73,40,16,97
24Q293,2017,143,126,126,59,1,17,9,99,6,0,12,74,69,127,16,28,115
24Q293,2016,134,121,121,39,5,20,9,91,6,0,8,74,60,114,20,24,110
24Q293,2015,118,108,101,7,7,11,6,75,13,0,13,64,54,91,27,27,91
24Q293,2014,122,112,108,42,4,21,8,75,7,0,11,57,65,100,22,15,107
24Q293,2013,116,109,107,26,2,12,9,81,7,0,7,64,52,98,18,18,98
24Q293,2012,112,101,98,18,5,5,8,90,5,0,4,64,48,75,37,13,99
24Q293,2011,121,104,101,30,7,10,7,98,6,0,0,73,48,85,36,20,101
24Q293,2010,86,69,68,17,7,9,8,67,2,0,0,46,40,63,23,22,64
24Q293,2009,113,94,92,19,9,7,11,90,3,1,1,56,57,70,43,20,93
24Q293,2008,105,83,83,18,5,5,11,84,5,0,0,53,52,72,33,12,93
24Q296,2017,102,95,93,0,7,1,0,69,0,0,0,51,51,95,7,3,99
24Q296,2016,100,89,85,0,8,0,1,101,0,0,0,39,61,74,26,2,98
24Q296,2015,146,112,106,0,15,0,0,99,0,1,0,77,69,125,21,4,142
24Q296,2014,94,79,71,0,5,0,0,146,0,0,0,48,46,82,12,5,89
24Q296,2013,98,83,82,0,7,0,0,94,0,0,0,47,51,85,13,1,97
24Q296,2012,70,51,51,0,13,0,0,98,0,0,0,31,39,62,8,5,65
24Q296,2011,90,60,59,0,11,0,0,90,0,0,0,48,42,76,14,2,88
24Q296,2010,65,30,30,0,12,0,0,65,0,0,0,30,35,55,10,0,65
24Q296,2009,90,33,33,0,13,0,0,90,0,0,0,43,47,73,17,0,90
24Q296,2008,99,40,38,0,9,0,0,99,0,0,0,54,45,82,17,1,98
24Q296,2007,80,34,24,1,13,0,0,80,0,0,0,30,50,57,23,1,79
24Q299,2017,160,154,154,0,0,54,10,33,60,0,3,110,50,75,85,9,151
24Q299,2016,152,151,151,0,0,55,19,28,47,1,2,96,56,63,89,4,148
24Q299,2015,141,137,137,0,0,54,16,18,53,0,0,80,61,56,85,0,141
24Q299,2014,151,150,150,0,0,49,20,28,46,1,7,93,58,64,87,2,149
24Q299,2013,143,142,142,0,0,52,14,23,49,1,4,81,62,57,86,4,139
24Q299,2012,154,150,150,0,0,49,14,28,57,2,4,100,54,59,95,1,153
24Q299,2011,170,164,164,0,0,61,22,27,60,0,0,98,72,77,93,1,169
24Q299,2010,130,128,128,0,0,49,15,22,41,0,3,74,56,63,67,0,130
24Q299,2009,140,133,133,0,1,39,21,36,44,0,0,98,42,60,80,0,140
24Q299,2008,178,178,178,0,0,52,43,40,43,0,0,106,72,98,80,1,177
24Q299,2007,55,51,51,1,0,11,10,17,16,1,0,37,18,33,22,0,55
24Q299,2006,50,48,48,0,0,12,11,14,12,1,0,35,15,25,25,0,50
24Q455,2017,463,321,321,166,50,120,29,269,29,9,7,194,269,331,132,59,404
24Q455,2016,433,317,317,105,48,131,22,244,24,2,10,165,268,340,93,38,395
24Q455,2015,512,347,334,53,57,124,48,308,28,3,1,188,324,402,110,63,449
24Q455,2014,640,432,410,57,55,160,50,389,34,7,0,274,366,511,129,67,573
24Q455,2013,495,313,294,34,62,129,46,295,20,3,2,224,271,371,124,60,435
24Q455,2012,403,266,251,22,63,96,32,257,17,1,0,177,226,291,112,56,347
24Q455,2011,453,257,245,26,67,138,33,257,21,1,3,203,250,313,140,55,398
24Q455,2010,626,344,317,47,93,175,53,362,29,4,3,258,368,455,171,69,557
24Q455,2009,747,379,343,63,88,211,69,438,27,1,1,328,419,541,206,64,683
24Q455,2008,696,441,416,72,92,177,64,414,39,0,2,272,424,432,264,67,629
24Q455,2007,805,459,369,72,121,182,64,519,39,1,0,335,470,439,366,73,732
24Q455,2006,773,382,259,88,125,194,55,493,30,0,1,338,435,430,343,66,707
24Q455,2005,880,441,250,124,170,228,67,548,35,1,1,369,511,390,490,102,778
24Q455,2004,872,401,250,134,180,214,73,533,51,0,1,395,477,476,396,85,787
24Q455,2003,1044,446,277,139,220,277,79,642,43,2,1,491,553,792,252,77,967
24Q455,2002,984,425,275,86,184,269,68,588,57,1,1,442,542,867,117,64,920
24Q455,2001,889,396,262,73,172,233,82,532,42,0,0,412,477,818,71,75,814
24Q485,2017,407,285,284,85,21,44,22,254,77,5,5,173,234,294,113,67,340
24Q485,2016,457,300,300,76,39,44,33,295,78,3,4,222,235,334,123,82,375
24Q485,2015,450,261,233,42,49,49,28,274,86,4,9,191,259,319,131,70,380
24Q485,2014,402,237,212,33,45,38,15,262,81,0,6,163,239,278,124,73,329
24Q485,2013,413,242,228,29,44,36,27,266,78,2,4,175,238,260,153,70,343
24Q485,2012,388,230,209,38,53,39,20,243,81,2,3,186,202,261,127,61,327
24Q485,2011,444,270,253,40,75,55,10,286,93,0,0,172,272,288,156,66,378
24Q485,2010,485,250,238,25,49,51,31,286,115,2,0,231,254,339,146,80,405
24Q485,2009,602,307,291,32,77,48,18,396,139,1,0,261,341,406,196,62,540
24Q485,2008,664,323,304,36,113,54,29,416,165,0,0,316,348,435,229,85,579
24Q485,2007,785,386,318,62,144,55,28,509,187,5,1,358,427,773,12,92,693
24Q485,2006,703,381,254,69,120,55,25,435,183,2,3,340,363,680,23,65,638
24Q485,2005,807,410,205,68,160,53,31,507,215,0,1,357,450,736,71,90,717
24Q485,2004,759,415,232,90,147,51,23,491,183,1,10,363,396,334,425,78,681
24Q485,2003,705,359,206,94,165,46,28,404,219,4,4,360,345,276,429,67,638
24Q485,2002,625,294,165,72,165,48,27,361,188,1,0,303,322,229,396,48,577
24Q485,2001,613,306,179,79,122,46,30,354,182,1,0,274,339,217,396,84,529
24Q520,2017,109,93,93,0,0,10,2,87,10,0,0,64,45,82,27,17,92
24Q520,2016,103,85,85,0,0,10,3,80,9,1,0,51,52,75,28,19,84
24Q520,2015,115,84,83,0,0,11,3,88,12,1,0,63,52,84,31,16,99
24Q520,2014,108,95,95,0,0,11,1,87,9,0,0,46,62,69,39,17,91
24Q520,2013,109,72,72,0,8,12,10,81,4,2,0,49,60,57,52,16,93
24Q520,2012,173,136,136,0,5,15,10,136,12,0,0,79,94,84,89,24,149
24Q520,2011,113,75,74,0,11,5,3,93,12,0,0,51,62,52,61,20,93
24Q520,2010,79,55,54,0,8,5,2,66,6,0,0,38,41,40,39,6,73
24Q520,2009,62,30,30,0,5,4,12,38,8,0,0,29,33,62,0,6,56
24Q520,2008,180,74,69,0,7,18,21,115,26,0,0,92,88,180,0,22,158
24Q520,2007,101,77,76,0,9,12,16,61,11,1,0,51,50,101,0,13,88
24Q520,2006,94,66,64,0,10,7,8,69,10,0,0,53,41,92,2,11,83
24Q520,2005,44,31,31,0,5,4,3,24,13,0,0,24,20,44,0,2,42
24Q520,2004,103,53,50,0,3,7,11,68,16,1,0,42,61,103,0,8,95
24Q520,2003,108,50,49,0,5,13,10,68,17,0,0,61,47,107,1,8,100
24Q520,2002,131,58,0,0,12,12,13,74,32,0,0,80,51,106,25,11,120
24Q520,2001,89,40,0,0,12,3,14,48,24,0,0,55,34,61,28,7,82
24Q530,2017,106,94,94,0,6,25,1,70,10,0,0,54,52,83,23,4,102
24Q530,2016,111,93,93,0,7,24,3,74,10,0,0,61,50,78,33,3,108
24Q530,2015,114,89,87,0,5,25,3,72,14,0,0,68,46,79,35,2,112
24Q530,2014,118,95,93,0,7,42,2,56,17,0,1,68,50,86,32,2,116
24Q530,2013,116,91,89,0,6,42,3,51,19,1,0,54,62,49,67,3,113
24Q530,2012,167,143,143,0,5,74,3,71,19,0,0,94,73,90,77,2,165
24Q530,2011,99,80,80,0,4,41,3,46,9,0,0,52,47,36,63,1,98
24Q530,2010,112,87,87,0,5,49,5,48,10,0,0,62,50,58,54,0,112
24Q530,2009,102,58,58,0,8,44,2,48,8,0,0,60,42,102,0,1,101
24Q530,2008,118,59,58,0,10,49,1,52,16,0,0,65,53,99,19,0,118
24Q530,2007,116,67,67,0,9,45,1,59,11,0,0,59,57,91,25,0,116
24Q530,2006,124,60,60,0,10,37,4,67,16,0,0,69,55,97,27,0,124
24Q530,2005,95,68,64,0,7,45,2,35,13,0,0,43,52,95,0,0,95
24Q530,2004,116,61,57,0,9,35,5,53,23,0,0,74,42,112,4,0,116
24Q530,2003,45,31,31,0,3,16,1,19,9,0,0,26,19,45,0,0,45
24Q530,2002,109,47,0,0,2,40,5,38,26,0,0,51,58,91,18,0,109
24Q530,2001,112,60,0,0,6,33,1,55,22,1,0,64,48,67,45,0,112
24Q550,2017,172,168,168,156,1,14,12,135,3,1,7,94,78,128,44,21,151
24Q550,2016,173,161,161,131,5,15,10,131,13,3,1,83,90,128,45,31,142
24Q550,2015,185,178,177,102,2,14,19,141,11,0,0,106,79,122,63,22,163
24Q550,2014,200,185,183,103,2,26,19,144,9,1,1,127,73,137,63,34,166
24Q550,2013,182,163,162,61,5,14,18,143,7,0,0,98,84,97,85,33,149
24Q550,2012,217,193,188,39,9,22,9,179,7,0,0,122,95,114,103,34,183
24Q550,2011,240,217,215,49,10,25,17,187,11,0,0,135,105,140,100,27,213
24Q550,2010,210,179,177,27,6,21,24,162,2,1,0,124,86,111,99,32,178
24Q550,2009,165,131,125,17,9,9,14,135,6,1,0,91,74,165,0,21,144
24Q550,2008,183,150,146,25,11,19,14,143,7,0,0,100,83,183,0,21,162
24Q550,2007,189,142,135,28,17,15,11,157,5,1,0,120,69,189,0,27,162
24Q550,2006,187,126,114,21,17,13,13,160,1,0,0,108,79,181,6,22,165
24Q550,2005,172,106,92,26,16,7,13,150,2,0,0,93,79,135,37,17,155
24Q550,2004,172,97,90,5,26,10,8,151,3,0,0,95,77,133,39,20,152
24Q550,2003,130,82,72,20,13,7,12,105,6,0,0,74,56,103,27,12,118
24Q550,2002,183,93,84,10,15,5,20,144,14,0,0,108,75,143,40,6,177
24Q550,2001,189,101,84,15,18,7,16,156,10,0,0,118,71,165,24,3,186
24Q560,2017,114,107,107,0,1,24,4,70,16,0,0,52,62,94,20,17,97
24Q560,2016,127,125,125,73,2,21,2,74,28,0,2,62,65,93,34,19,108
24Q560,2015,119,115,110,9,0,26,6,77,10,0,0,45,74,104,15,19,100
24Q560,2014,114,107,94,0,3,25,8,66,13,0,2,45,69,100,14,14,100
24Q560,2013,108,99,90,0,2,19,2,77,9,0,1,62,46,93,15,14,94
24Q560,2012,133,115,106,0,2,25,7,82,18,0,1,47,86,105,28,15,118
24Q560,2011,121,99,94,1,2,23,4,81,12,1,0,56,65,96,25,17,104
24Q560,2010,111,89,85,0,1,18,14,67,12,0,0,67,44,84,27,18,93
24Q560,2009,106,91,88,8,1,25,3,69,9,0,0,53,53,79,27,12,94
24Q560,2008,113,88,86,4,6,18,8,75,12,0,0,59,54,85,28,14,99
24Q560,2007,115,82,50,4,3,13,3,83,14,2,0,71,44,89,26,21,94
24Q560,2006,95,59,41,6,4,10,16,53,16,0,0,49,46,63,32,21,74
24Q560,2005,86,59,44,3,6,12,9,48,15,1,1,45,41,58,28,11,75
24Q560,2004,91,52,29,1,7,8,14,58,10,0,1,53,38,67,24,11,80
24Q560,2003,89,55,25,1,8,8,22,46,10,1,2,53,36,58,31,8,81
24Q560,2002,84,53,32,0,17,7,18,44,15,0,0,42,42,37,47,4,80
24Q560,2001,76,52,24,0,6,4,24,29,19,0,0,42,34,48,28,7,69
24Q585,2017,400,394,394,214,1,62,6,200,105,4,23,222,178,221,179,66,334
24Q585,2016,262,256,255,132,1,50,2,102,80,0,28,119,143,130,132,46,216
24Q585,2015,249,244,241,104,2,43,6,106,81,0,13,129,120,128,121,32,217
24Q585,2014,243,238,238,61,1,48,1,93,101,0,0,116,127,139,104,33,210
24Q585,2013,258,252,245,90,0,37,4,125,90,2,0,145,113,189,69,32,226
24Q585,2012,237,235,234,102,1,42,8,101,86,0,0,128,109,159,78,22,215
24Q585,2011,230,223,222,69,4,45,10,105,69,1,0,126,104,149,81,17,213
24Q600,2017,371,286,286,158,5,44,20,290,17,0,0,132,239,299,72,67,304
24Q600,2016,326,271,271,123,10,36,13,264,13,0,0,145,181,280,46,54,272
24Q600,2015,359,278,271,52,14,31,18,291,19,0,0,138,221,310,49,59,300
24Q600,2014,357,285,278,54,4,54,19,257,26,0,1,115,242,292,65,53,304
24Q600,2013,358,290,283,36,11,30,16,286,25,1,0,145,213,298,60,46,312
24Q600,2012,418,339,330,58,28,52,25,306,34,1,0,155,263,339,79,51,367
24Q600,2011,368,273,265,38,26,42,22,280,24,0,0,142,226,305,63,47,321
24Q600,2010,308,232,225,34,14,26,17,236,29,0,0,125,183,275,33,36,272
24Q600,2009,334,250,239,20,16,44,24,235,31,0,0,136,198,284,50,43,291
24Q600,2008,326,216,206,21,30,30,24,239,33,0,0,113,213,267,59,52,274
24Q600,2007,270,195,170,17,24,25,26,195,24,0,0,109,161,223,47,37,233
24Q600,2006,271,192,157,26,29,26,23,186,35,1,0,103,168,211,60,41,230
24Q600,2005,277,192,131,26,19,28,43,172,34,0,0,114,163,190,87,50,227
24Q600,2004,230,98,76,33,39,12,40,146,32,0,0,87,143,169,61,37,193
24Q600,2003,250,127,69,56,43,19,36,164,29,1,1,88,162,200,50,51,199
24Q600,2002,288,135,97,43,63,27,27,177,57,0,0,129,159,261,27,40,248
24Q600,2001,273,144,68,2,50,25,38,165,45,0,0,100,173,237,36,34,239
24Q610,2017,459,437,437,223,2,179,16,206,42,4,12,103,356,296,163,76,383
24Q610,2016,441,428,423,230,0,165,20,191,37,3,25,82,359,279,162,59,382
24Q610,2015,463,441,429,252,1,151,18,229,45,3,17,83,380,304,159,58,405
24Q610,2014,472,435,424,257,4,166,26,206,55,5,14,111,361,288,184,72,400
24Q610,2013,647,610,605,324,6,209,33,308,76,4,17,121,526,283,364,38,609
24Q610,2012,469,419,407,219,3,118,34,243,58,4,12,91,378,181,288,43,426
24Q610,2011,515,440,432,235,5,156,31,274,51,3,0,79,436,243,272,30,485
24Q610,2010,491,424,422,237,4,143,27,270,48,3,0,69,422,235,256,28,463
24Q610,2009,487,402,396,156,7,122,28,291,45,1,0,61,426,487,0,21,466
24Q610,2008,462,393,389,174,7,101,40,272,45,4,0,63,399,462,0,19,443
24Q610,2007,423,349,336,151,3,100,30,255,37,1,0,74,349,419,4,16,407
24Q610,2006,368,274,262,157,5,86,33,210,37,1,1,47,321,263,105,23,345
24Q610,2005,459,285,257,106,7,114,40,260,41,0,4,66,393,329,130,13,446
24Q610,2004,361,275,227,161,9,83,24,201,49,0,4,70,291,256,105,24,337
24Q610,2003,366,256,214,140,10,79,37,193,50,0,7,32,334,242,124,34,332
24Q610,2002,424,290,196,62,17,71,42,229,79,3,0,35,389,267,157,11,413
24Q610,2001,209,126,94,27,8,35,32,112,30,0,0,16,193,124,85,24,185
24Q744,2017,84,6,6,0,6,1,17,58,6,1,1,41,43,64,20,18,66
24Q744,2016,102,6,5,0,0,6,15,76,5,0,0,46,56,86,16,17,85
24Q744,2015,75,9,9,0,8,7,4,57,5,0,2,23,52,55,20,8,67
24Q744,2014,76,13,13,0,6,6,10,56,2,2,0,33,43,62,14,3,73
24Q744,2013,106,14,14,0,3,6,16,78,6,0,0,38,68,78,28,8,98
24Q744,2012,65,3,3,0,16,7,10,44,3,0,1,29,36,48,17,3,62
24Q744,2011,77,10,9,0,11,4,14,55,4,0,0,37,40,60,17,11,66
24Q744,2010,90,11,11,0,14,8,11,63,7,1,0,43,47,69,21,3,87
24Q744,2009,119,20,20,0,25,14,36,63,5,1,0,60,59,96,23,5,114
24Q744,2008,117,14,14,0,35,5,24,75,13,0,0,47,70,89,28,10,107
24Q744,2007,98,14,8,0,14,4,29,60,5,0,0,61,37,68,30,7,91
24Q744,2006,85,10,6,0,10,9,22,49,5,0,0,37,48,63,22,2,83
24Q744,2005,71,3,2,0,8,5,24,35,6,1,0,34,37,53,18,4,67
25Q240,2017,158,131,131,32,8,15,19,109,13,0,2,95,63,128,30,27,131
25Q240,2016,142,121,121,20,3,21,12,85,16,3,5,67,75,99,43,19,123
25Q240,2015,139,108,97,16,7,21,21,70,17,1,9,65,74,90,49,24,115
25Q240,2014,114,95,88,5,5,28,9,53,23,1,0,61,53,76,38,23,91
25Q240,2013,136,104,100,26,4,28,20,67,19,0,2,66,70,99,37,24,112
25Q241,2017,105,94,94,73,3,59,6,35,3,0,2,58,47,89,16,5,100
25Q241,2016,106,96,96,61,0,64,8,29,2,1,2,67,39,91,15,5,101
25Q241,2015,103,94,91,55,1,73,8,19,1,2,0,49,54,86,17,9,94
25Q241,2014,101,98,97,59,0,54,14,28,4,1,0,62,39,89,12,6,95
25Q241,2013,82,77,77,44,1,59,5,16,1,1,0,38,44,73,9,4,78
25Q252,2017,81,77,77,51,1,26,18,19,16,0,2,46,35,43,38,14,67
25Q252,2016,85,84,84,43,0,29,10,27,15,1,3,40,45,36,49,16,69
25Q252,2015,78,75,74,25,2,27,13,18,17,0,3,45,33,47,31,11,67
25Q252,2014,69,62,61,27,3,28,12,12,17,0,0,31,38,36,33,7,62
25Q252,2013,77,71,70,33,1,28,15,18,12,1,3,31,46,38,39,11,66
25Q252,2012,75,73,73,38,2,27,13,17,13,0,5,42,33,28,47,6,69
25Q252,2011,68,63,63,26,2,23,15,15,15,0,0,40,28,29,39,9,59
25Q252,2010,72,68,66,29,1,28,14,19,11,0,0,48,24,34,38,7,65
25Q252,2009,77,70,70,21,1,41,5,19,11,1,0,38,39,29,48,5,72
25Q252,2008,67,57,57,15,0,20,13,21,11,1,1,33,34,31,36,7,60
25Q263,2017,103,83,83,0,7,41,2,58,2,0,0,40,63,88,15,3,100
25Q263,2016,83,67,66,0,6,39,1,40,3,0,0,46,37,70,13,4,79
25Q263,2015,107,62,57,0,21,59,1,40,6,1,0,47,60,94,13,2,105
25Q263,2014,109,70,64,0,14,52,0,51,4,2,0,44,65,99,10,1,108
25Q263,2013,99,57,55,0,20,56,3,39,1,0,0,43,56,80,19,3,96
25Q263,2012,94,66,63,0,6,55,3,33,2,1,0,47,47,85,9,0,94
25Q263,2011,96,64,64,0,10,66,2,25,3,0,0,35,61,86,10,1,95
25Q263,2010,85,52,52,0,7,57,1,24,2,0,1,39,46,83,2,3,82
25Q263,2009,101,63,63,0,9,65,1,33,2,0,0,51,50,88,13,0,101
25Q263,2008,87,47,47,0,12,44,1,42,0,0,0,33,54,77,10,0,87
25Q263,2007,93,50,44,0,8,41,1,51,0,0,0,46,47,92,1,1,92
25Q263,2006,86,51,38,0,9,32,3,50,1,0,0,42,44,86,0,0,86
25Q263,2005,99,57,37,0,7,39,2,56,2,0,0,53,46,97,2,2,97
25Q263,2004,88,57,30,0,6,36,1,50,1,0,0,38,50,79,9,1,87
25Q281,2017,86,83,63,14,1,56,10,12,7,0,1,38,48,63,23,11,75
25Q281,2016,96,94,92,45,0,57,11,19,7,2,0,41,55,77,19,16,80
25Q281,2015,73,70,64,32,1,47,10,13,2,1,0,39,34,60,13,12,61
25Q281,2014,85,80,78,24,3,46,12,24,2,1,0,34,51,80,5,7,78
25Q281,2013,86,80,71,27,1,49,14,13,6,0,4,50,36,65,21,9,77
25Q281,2012,86,83,78,30,0,54,9,20,3,0,0,41,45,74,12,8,78
25Q281,2011,104,92,89,27,2,68,14,14,7,0,1,46,58,89,15,8,96
25Q281,2010,86,79,76,22,0,50,15,19,2,0,0,33,53,70,16,12,74
25Q281,2009,92,83,81,33,3,49,21,20,1,1,0,53,39,68,24,4,88
25Q281,2008,63,57,55,15,1,30,16,15,1,0,1,27,36,54,9,3,60
25Q281,2007,83,69,68,12,1,39,17,19,7,1,0,33,50,59,24,6,77
25Q281,2006,75,64,58,20,0,41,14,17,3,0,0,37,38,47,28,3,72
25Q285,2017,84,84,84,52,0,15,4,35,28,0,2,50,34,48,36,12,72
25Q285,2016,80,75,75,24,2,9,5,25,38,1,2,46,34,49,31,15,65
25Q285,2015,73,70,66,10,1,4,1,26,42,0,0,42,31,36,37,16,57
25Q285,2014,72,68,66,4,0,7,9,16,40,0,0,49,23,35,37,14,58
25Q285,2013,89,86,86,14,0,19,7,21,42,0,0,49,40,53,36,22,67
25Q285,2012,102,91,88,15,2,14,9,24,55,0,0,55,47,45,57,19,83
25Q285,2011,93,85,80,4,1,13,11,23,46,0,0,58,35,50,43,17,76
25Q285,2010,79,74,64,4,0,12,5,16,45,1,0,51,28,41,38,19,60
25Q285,2009,80,71,66,5,2,10,9,21,40,0,0,55,25,38,42,11,69
25Q285,2008,71,61,59,8,2,9,7,11,44,0,0,43,28,25,46,11,60
25Q285,2007,72,63,56,13,3,10,4,18,39,1,0,51,21,37,35,9,63
25Q285,2006,82,71,66,3,1,8,20,37,17,0,0,46,36,52,30,9,73
25Q425,2017,859,618,618,336,30,261,138,388,53,12,7,419,440,674,185,126,733
25Q425,2016,875,625,625,349,42,257,147,405,46,6,14,438,437,709,166,112,763
25Q425,2015,890,645,592,138,78,275,167,386,46,8,8,464,426,724,166,134,756
25Q425,2014,876,636,599,133,70,268,148,390,51,4,15,404,472,700,176,111,765
25Q425,2013,890,621,564,105,89,268,157,409,37,6,13,465,425,659,231,117,773
25Q425,2012,783,546,504,87,87,208,160,363,43,3,6,381,402,580,203,114,669
25Q425,2011,909,616,596,138,77,327,148,386,39,7,2,463,446,724,185,101,808
25Q425,2010,908,561,537,138,78,331,166,351,58,2,0,455,453,684,224,88,820
25Q425,2009,916,562,541,134,104,336,182,352,44,2,0,460,456,729,187,80,836
25Q425,2008,970,578,561,144,94,329,193,383,55,10,0,468,502,719,251,86,884
25Q425,2007,714,441,370,77,107,221,132,332,26,3,0,349,365,524,190,78,636
25Q425,2006,688,386,297,68,142,170,176,310,30,2,0,346,342,453,235,83,605
25Q425,2005,699,374,254,57,118,157,174,337,26,5,0,341,358,555,144,80,619
25Q425,2004,810,487,326,97,108,234,186,342,44,3,1,409,401,607,203,83,727
25Q425,2003,793,405,243,75,163,242,147,353,42,0,9,409,384,554,239,55,738
25Q425,2002,853,375,248,58,207,271,174,358,48,2,0,437,416,535,318,62,791
25Q425,2001,821,361,210,71,190,264,146,353,53,5,0,418,403,509,312,66,755
25Q460,2017,320,264,264,178,38,64,38,194,8,9,7,148,172,267,53,21,299
25Q460,2016,383,294,294,111,44,51,73,235,14,2,8,190,193,304,79,42,341
25Q460,2015,398,271,244,34,62,69,67,246,13,2,1,182,216,318,80,52,346
25Q460,2014,382,214,195,21,66,59,73,235,11,4,0,175,207,303,79,58,324
25Q460,2013,419,241,225,25,80,78,69,248,18,6,0,184,235,279,140,63,356
25Q460,2012,537,302,282,23,96,98,132,286,17,4,0,244,293,370,167,81,456
25Q460,2011,696,389,377,49,104,177,171,314,29,5,0,312,384,511,185,79,617
25Q460,2010,755,396,376,94,115,162,184,380,24,5,0,303,452,519,236,92,663
25Q460,2009,833,403,394,66,122,180,193,431,24,5,0,402,431,598,235,82,751
25Q460,2008,710,400,386,83,101,126,156,394,32,2,0,308,402,493,217,92,618
25Q460,2007,713,397,353,80,116,162,135,385,31,0,0,298,415,491,222,75,638
25Q460,2006,588,332,281,50,122,100,117,356,15,0,0,296,292,403,185,76,512
25Q460,2005,559,290,238,52,108,114,107,304,19,4,11,257,302,350,209,58,501
25Q460,2004,607,299,241,62,130,124,132,311,39,1,0,294,313,356,251,55,552
25Q460,2003,561,264,185,49,154,150,105,272,31,1,2,246,315,319,242,52,509
25Q460,2002,636,266,194,44,164,186,143,263,44,0,0,306,330,335,301,30,606
25Q460,2001,597,257,195,70,152,165,116,277,38,1,0,288,309,299,298,54,543
25Q525,2017,292,292,292,280,0,170,15,27,52,2,26,208,84,165,127,11,281
25Q525,2016,292,291,291,277,0,172,14,33,52,1,20,203,89,152,140,13,279
25Q525,2015,288,287,287,279,1,161,13,45,63,3,3,193,95,142,146,4,284
25Q525,2014,291,290,290,281,1,178,18,19,68,5,3,211,80,171,120,7,284
25Q525,2013,261,259,259,257,0,157,15,35,54,0,0,177,84,144,117,1,260
25Q525,2012,281,281,281,277,0,163,20,38,54,2,4,196,85,163,118,0,281
25Q525,2011,310,310,310,307,0,182,19,32,71,3,3,229,81,155,155,2,308
25Q525,2010,282,282,282,277,0,161,15,36,67,1,2,192,90,132,150,0,282
25Q525,2009,268,268,268,262,0,141,19,40,67,1,0,184,84,137,131,0,268
25Q525,2008,269,268,268,265,0,146,12,36,72,0,3,197,72,111,158,1,268
25Q525,2007,273,272,272,271,0,141,17,33,80,0,2,181,92,273,0,2,271
25Q525,2006,278,278,278,271,0,139,20,27,81,0,11,196,82,278,0,1,277
25Q525,2005,251,250,250,249,0,123,20,34,74,0,0,178,73,251,0,1,250
25Q525,2004,271,269,269,266,0,140,21,30,80,0,0,201,70,107,164,0,271
25Q525,2003,274,272,272,269,0,111,23,32,108,0,0,176,98,100,174,1,273
25Q525,2002,254,252,252,251,0,78,13,29,134,0,0,178,76,78,176,0,254
25Q525,2001,279,279,279,279,0,105,20,20,133,1,0,208,71,92,187,1,278
25Q540,2017,132,15,15,1,0,27,5,91,8,1,0,55,77,104,28,32,100
25Q540,2016,157,23,22,1,4,23,15,104,15,0,0,56,101,123,34,45,112
25Q540,2015,159,20,18,0,9,20,27,92,17,2,1,72,87,125,34,32,127
25Q540,2014,155,15,12,0,25,14,56,69,10,6,0,64,91,107,48,26,129
25Q540,2013,165,12,7,0,30,21,57,72,7,8,0,68,97,130,35,30,135
25Q540,2012,146,19,16,2,23,25,45,57,13,5,1,60,86,101,45,15,131
25Q540,2011,158,17,14,1,22,21,53,63,19,1,1,71,87,112,46,19,139
25Q540,2010,136,22,21,1,21,22,49,54,9,2,0,70,66,108,28,17,119
25Q540,2009,198,40,36,1,31,21,79,81,17,0,0,115,83,150,48,22,176
25Q540,2008,174,37,35,0,26,22,83,59,9,1,0,92,82,142,32,13,161
25Q540,2007,187,38,23,1,23,30,81,65,11,0,0,76,111,136,51,16,171
25Q540,2006,141,31,19,2,15,13,51,65,12,0,0,78,63,112,29,11,130
25Q540,2005,56,27,17,1,26,10,21,17,6,1,1,33,23,37,19,0,56
25Q540,2004,121,25,10,0,10,13,68,27,13,0,0,66,55,77,44,7,114
25Q540,2003,171,14,6,0,17,17,95,48,11,0,0,89,82,118,53,12,159
25Q540,2002,203,11,2,0,10,18,108,65,11,1,0,99,104,146,57,18,185
25Q540,2001,196,10,0,0,10,18,75,81,21,1,0,110,86,112,84,9,187
25Q670,2017,158,136,136,41,7,59,25,51,21,0,2,65,93,132,26,31,127
25Q670,2016,186,146,145,59,5,66,24,64,26,3,3,90,96,147,39,29,157
25Q670,2015,185,159,152,53,6,73,15,60,29,2,6,79,106,158,27,24,161
25Q670,2014,183,133,121,27,4,60,26,69,23,0,5,90,93,148,35,24,159
25Q670,2013,169,126,110,23,8,55,24,61,28,0,1,68,101,137,32,32,137
25Q670,2012,170,140,129,23,6,60,15,59,36,0,0,83,87,137,33,31,139
25Q670,2011,158,134,122,28,10,50,19,52,37,0,0,62,96,116,42,30,128
25Q670,2010,147,113,108,20,6,39,16,59,33,0,0,71,76,115,32,33,114
25Q670,2009,177,123,119,29,6,51,14,55,57,0,0,85,92,116,61,29,148
25Q670,2008,163,116,112,23,8,54,20,56,33,0,0,85,78,114,49,24,139
25Q670,2007,190,127,121,26,12,51,32,56,51,0,0,87,103,80,110,29,161
25Q670,2006,159,90,83,21,13,36,21,51,50,1,0,73,86,65,94,29,130
25Q670,2005,112,85,71,18,7,23,20,33,36,0,0,55,57,44,68,27,85
25Q670,2004,126,87,79,6,6,29,19,45,31,1,1,66,60,24,102,14,112
25Q670,2003,95,73,59,0,7,20,11,21,40,1,2,48,47,82,13,7,88
25Q670,2002,113,73,60,21,17,28,16,20,49,0,0,66,47,105,8,8,105
25Q670,2001,113,87,77,28,4,26,6,29,52,0,0,70,43,110,3,5,108
25Q792,2017,41,1,1,0,3,5,15,16,3,2,0,16,25,28,13,6,35
25Q792,2016,58,5,5,0,6,8,20,21,7,1,1,32,26,43,15,9,49
25Q792,2015,83,8,7,0,10,10,33,28,11,1,0,41,42,57,26,15,68
25Q792,2014,84,5,5,0,20,6,35,34,7,1,1,38,46,67,17,16,68
25Q792,2013,95,8,7,0,18,13,41,28,10,3,0,43,52,63,32,22,73
25Q792,2012,72,3,2,0,12,9,29,29,5,0,0,29,43,55,17,17,55
25Q792,2011,82,11,7,0,18,8,24,35,14,1,0,49,33,62,20,19,63
25Q792,2010,94,8,7,0,9,17,32,30,15,0,0,56,38,64,30,11,83
25Q792,2009,91,14,13,0,18,9,28,40,14,0,0,50,41,65,26,15,76
25Q792,2008,87,9,8,0,14,11,39,25,12,0,0,46,41,56,31,15,72
25Q792,2007,66,11,9,0,6,8,25,24,9,0,0,33,33,46,20,6,60
25Q792,2006,62,12,7,0,7,3,30,22,7,0,0,30,32,40,22,5,57
25Q792,2005,106,13,8,0,7,14,34,46,12,0,0,49,57,44,62,15,91
25Q792,2004,66,6,3,0,5,10,22,27,7,0,0,35,31,31,35,7,59
25Q792,2003,19,0,0,0,0,3,4,12,0,0,0,8,11,10,9,2,17
26Q315,2017,119,116,116,60,0,30,50,23,7,6,3,40,79,85,34,12,107
26Q315,2016,108,102,92,22,1,25,48,19,6,6,4,40,68,81,27,14,94
26Q315,2015,102,92,80,3,3,29,39,17,9,0,8,27,75,68,34,18,84
26Q315,2014,89,79,74,3,1,26,27,21,10,1,4,27,62,66,23,11,78
26Q415,2017,799,709,708,481,10,343,166,157,116,6,11,444,355,508,291,98,701
26Q415,2016,864,792,791,486,27,368,184,177,118,8,9,446,418,555,309,110,754
26Q415,2015,942,826,801,366,40,415,200,178,133,8,8,497,445,591,351,94,848
26Q415,2014,891,760,727,342,35,397,176,182,126,7,3,451,440,590,301,103,788
26Q415,2013,865,762,738,297,22,408,152,157,138,3,7,450,415,410,455,94,771
26Q415,2012,866,754,728,267,25,355,196,167,133,8,7,452,414,483,383,88,778
26Q415,2011,861,762,743,350,25,417,158,151,128,6,1,455,406,467,394,70,791
26Q415,2010,983,797,768,453,45,460,166,183,162,8,4,520,463,526,457,117,866
26Q415,2009,1008,822,797,396,32,469,188,186,158,4,3,526,482,546,462,83,925
26Q415,2008,1076,886,863,467,48,497,206,179,190,3,1,568,508,494,582,84,992
26Q415,2007,942,782,732,364,43,442,161,171,166,1,1,515,427,401,541,82,860
26Q415,2006,981,786,692,381,44,461,193,143,182,0,2,502,479,284,697,60,921
26Q415,2005,1013,783,703,380,55,455,202,145,207,3,1,558,455,172,841,70,943
26Q415,2004,1086,879,779,392,55,474,184,179,248,1,0,580,506,176,910,54,1032
26Q415,2003,1093,881,799,409,56,484,226,132,250,1,0,584,509,265,828,40,1053
26Q415,2002,1013,800,722,370,54,468,173,133,238,1,0,553,460,150,863,36,977
26Q415,2001,942,737,647,371,74,423,174,109,234,2,0,503,439,124,818,52,890
26Q430,2017,1114,1013,1013,775,12,626,71,231,179,6,1,543,571,762,352,149,965
26Q430,2016,1126,1001,998,727,29,656,64,225,177,3,1,565,561,797,329,138,988
26Q430,2015,1108,932,907,591,25,639,71,238,154,4,2,562,546,799,309,143,965
26Q430,2014,1180,956,927,592,43,687,64,233,185,8,3,577,603,861,319,140,1040
26Q430,2013,1015,847,830,533,26,566,69,218,153,6,3,510,505,756,259,112,903
26Q430,2012,1094,904,885,566,46,573,89,265,157,9,1,565,529,788,306,122,972
26Q430,2011,1046,841,821,515,37,574,89,231,147,5,0,526,520,787,259,130,916
26Q430,2010,1021,809,775,480,37,551,73,232,159,5,1,490,531,750,271,101,920
26Q430,2009,1167,945,907,584,60,610,106,273,175,3,0,627,540,902,265,120,1047
26Q430,2008,1148,952,911,604,45,572,86,316,172,2,0,579,569,764,384,102,1046
26Q430,2007,1167,935,843,561,60,614,98,264,190,1,0,593,574,636,531,120,1047
26Q430,2006,1209,897,791,495,62,565,148,304,189,3,0,631,578,542,667,96,1113
26Q430,2005,1134,887,733,456,27,563,136,229,205,1,0,553,581,432,702,108,1026
26Q430,2004,1084,850,707,469,58,539,133,245,166,1,0,514,570,291,793,81,1003
26Q430,2003,1113,858,753,465,79,532,165,208,208,0,0,601,512,381,732,69,1044
26Q430,2002,1007,734,641,392,91,476,101,208,220,2,0,541,466,155,852,64,943
26Q430,2001,1051,744,637,406,92,445,151,186,267,2,0,541,510,158,893,88,963
26Q435,2017,301,262,262,82,22,109,110,54,10,14,4,127,174,218,83,33,268
26Q435,2016,246,207,197,36,20,75,97,48,11,14,1,117,129,187,59,22,224
26Q435,2015,284,214,200,27,22,83,142,32,14,12,1,120,164,215,69,30,254
26Q435,2014,274,211,196,27,24,97,100,49,11,17,0,121,153,217,57,28,246
26Q435,2013,328,206,199,27,35,86,168,40,18,15,1,153,175,253,75,35,293
26Q435,2012,410,259,234,16,45,121,222,46,11,9,1,183,227,273,137,54,356
26Q435,2011,510,270,257,15,56,150,260,62,21,16,1,228,282,363,147,56,454
26Q435,2010,611,300,280,12,96,153,349,90,15,4,0,278,333,408,203,60,551
26Q435,2009,653,294,277,36,74,156,376,95,14,12,0,282,371,425,228,71,582
26Q435,2008,694,354,337,27,82,163,412,96,16,7,0,332,362,341,353,82,612
26Q435,2007,769,450,345,30,72,174,457,117,17,4,0,364,405,362,407,61,708
26Q435,2006,755,474,378,46,64,175,439,101,27,11,2,356,399,363,392,77,678
26Q435,2005,678,457,356,70,50,140,405,108,20,5,0,302,376,144,534,84,594
26Q435,2004,759,541,445,77,70,162,426,118,30,7,16,394,365,150,609,61,698
26Q435,2003,711,485,378,81,74,168,401,98,18,2,24,377,334,201,510,73,638
26Q435,2002,671,436,315,67,75,175,346,98,48,3,1,351,320,106,565,49,622
26Q435,2001,740,470,311,96,96,216,356,107,58,3,0,396,344,94,646,97,643
26Q495,2017,706,702,702,346,3,258,84,186,145,28,5,355,351,534,172,104,602
26Q495,2016,625,614,592,360,2,264,85,131,118,25,2,292,333,465,160,103,522
26Q495,2015,710,685,641,345,3,249,95,176,174,14,2,363,347,501,209,123,587
26Q495,2014,904,875,804,475,1,433,95,215,155,4,2,435,469,694,210,144,760
26Q495,2013,835,801,762,297,2,332,109,258,131,2,3,432,403,647,188,104,731
26Q495,2012,778,722,696,296,10,323,86,215,151,3,0,378,400,568,210,92,686
26Q495,2011,687,614,577,240,20,240,105,189,149,3,1,352,335,470,217,100,587
26Q495,2010,848,745,706,325,24,397,78,198,173,2,0,409,439,623,225,97,751
26Q495,2009,896,800,778,412,24,435,125,182,150,4,0,462,434,680,216,66,830
26Q495,2008,805,724,687,337,24,392,91,157,164,1,0,426,379,584,221,67,738
26Q495,2007,972,811,769,448,55,488,150,150,184,0,0,532,440,637,335,73,899
26Q495,2006,902,723,695,450,58,439,135,172,153,1,2,470,432,547,355,68,834
26Q495,2005,1085,854,825,578,56,492,185,195,201,2,10,583,502,691,394,58,1027
26Q495,2004,995,699,673,475,55,422,173,184,195,1,20,488,507,339,656,66,929
26Q495,2003,819,583,550,366,75,346,159,128,186,0,0,401,418,309,510,49,770
26Q495,2002,855,594,566,345,76,315,189,152,198,1,0,448,407,292,563,44,811
26Q495,2001,761,519,474,292,89,268,152,122,219,0,0,376,385,168,593,64,697
26Q566,2017,211,199,199,53,3,48,110,29,13,9,2,114,97,149,62,44,167
26Q566,2016,252,237,237,49,3,45,143,40,16,3,5,128,124,160,92,43,209
26Q566,2015,271,246,205,27,6,59,143,37,27,4,1,126,145,164,107,61,210
26Q566,2014,245,220,198,32,4,57,136,34,14,2,2,121,124,149,96,47,198
26Q566,2013,269,245,212,53,2,75,116,47,27,4,0,138,131,162,107,61,208
26Q566,2012,283,253,223,34,7,71,133,55,20,4,0,157,126,168,115,48,235
26Q566,2011,275,247,212,20,9,64,129,48,29,5,0,148,127,182,93,52,223
26Q566,2010,292,255,225,30,11,80,120,51,39,2,0,158,134,178,114,54,238
26Q566,2009,297,253,233,25,5,59,157,43,35,3,0,171,126,177,120,42,255
26Q566,2008,269,227,200,20,5,71,112,43,42,1,0,135,134,156,113,36,233
26Q566,2007,287,236,175,26,6,62,149,38,34,4,0,160,127,156,131,45,242
26Q566,2006,281,235,183,35,9,70,124,53,33,1,0,164,117,136,145,28,253
26Q566,2005,269,217,151,35,8,87,83,37,60,0,2,130,139,114,155,41,228
26Q566,2004,281,233,168,0,10,81,103,43,51,1,2,152,129,107,174,21,260
26Q566,2003,255,219,164,51,5,71,82,36,65,0,1,156,99,110,145,10,245
26Q566,2002,71,59,45,0,0,28,8,12,23,0,0,37,34,22,49,7,64
27Q260,2017,86,31,31,0,20,1,38,44,0,2,1,46,40,72,14,17,69
27Q260,2016,103,52,50,0,33,2,53,46,0,1,1,41,62,74,29,18,85
27Q260,2015,92,39,28,0,20,1,47,42,0,2,0,43,49,67,25,20,72
27Q260,2014,114,45,25,0,21,3,67,42,1,0,1,55,59,86,28,23,91
27Q260,2013,92,38,33,0,20,1,48,42,1,0,0,37,55,74,18,20,72
27Q260,2012,106,64,56,0,16,2,75,28,0,1,0,48,58,79,27,23,83
27Q260,2011,83,33,33,0,18,3,44,34,2,0,0,32,51,58,25,7,76
27Q260,2010,93,51,50,0,6,6,58,28,1,0,0,36,57,76,17,8,85
27Q260,2009,106,47,45,0,9,1,80,24,1,0,0,48,58,81,25,16,90
27Q260,2008,112,74,65,4,7,7,83,20,1,1,0,60,52,78,34,13,99
27Q260,2007,105,70,60,2,7,3,80,19,0,3,0,62,43,60,45,10,95
27Q260,2006,95,68,53,8,4,5,68,18,2,1,1,41,54,77,18,10,85
27Q260,2005,85,64,46,0,2,8,58,15,0,1,3,45,40,59,26,5,80
27Q260,2004,74,47,33,0,1,5,51,15,1,1,1,37,37,53,21,5,69
27Q261,2017,117,49,49,0,3,14,66,30,4,3,0,60,57,88,29,23,94
27Q261,2016,113,40,35,0,2,11,77,21,3,1,0,61,52,91,22,17,96
27Q261,2015,120,19,17,0,2,8,81,20,5,5,1,57,63,83,37,13,107
27Q261,2014,129,36,34,0,3,11,90,22,0,5,1,52,77,96,33,10,119
27Q261,2013,111,25,22,0,6,7,82,17,2,3,0,52,59,86,25,13,98
27Q261,2012,120,23,20,0,18,17,82,20,0,1,0,56,64,101,19,12,108
27Q261,2011,92,12,12,0,15,10,52,26,2,2,0,56,36,74,18,2,90
27Q261,2010,69,1,1,0,10,9,41,18,1,0,0,29,40,61,8,2,67
27Q262,2017,151,145,145,31,1,9,80,41,20,0,1,79,72,109,42,21,130
27Q262,2016,125,124,124,32,0,7,61,43,13,1,0,71,54,86,39,11,114
27Q262,2015,119,109,100,9,3,13,46,38,20,1,1,61,58,83,36,13,106
27Q262,2014,128,121,108,16,1,10,61,36,19,2,0,68,60,93,35,20,108
27Q262,2013,112,102,96,4,0,7,58,32,15,0,0,52,60,75,37,17,95
27Q262,2012,124,113,103,11,1,7,72,27,15,2,1,50,74,90,34,16,108
27Q262,2011,111,88,83,2,5,2,60,37,12,0,0,50,61,88,23,15,96
27Q262,2010,96,90,84,11,0,5,44,34,13,0,0,45,51,65,31,10,86
27Q262,2009,92,71,67,9,4,7,40,24,21,0,0,43,49,56,36,16,76
27Q262,2008,88,78,75,10,0,4,44,23,16,1,0,44,44,88,0,13,75
27Q262,2007,101,85,77,24,0,5,62,27,4,3,0,53,48,101,0,7,94
27Q262,2006,71,67,59,13,0,6,38,14,13,0,0,30,41,71,0,5,66
27Q262,2005,68,63,56,14,3,2,43,16,7,0,0,44,24,68,0,4,64
27Q262,2004,76,65,55,12,3,1,35,24,16,0,0,37,39,76,0,8,68
27Q302,2017,110,96,96,54,10,5,49,45,7,4,0,40,70,86,24,27,83
27Q302,2016,134,109,108,35,13,9,57,67,0,1,0,38,96,91,43,22,112
27Q302,2015,132,106,90,15,16,5,47,74,3,2,1,51,81,94,38,20,112
27Q302,2014,92,74,68,14,13,7,37,46,1,0,1,34,58,63,29,13,79
27Q302,2013,101,80,71,4,16,6,47,45,2,1,0,39,62,70,31,9,92
27Q302,2012,82,55,42,9,9,3,47,28,3,1,0,30,52,67,15,17,65
27Q302,2011,83,42,38,2,17,2,43,35,3,0,0,40,43,69,14,16,67
27Q302,2010,76,49,48,2,10,2,43,27,4,0,0,37,39,60,16,9,67
27Q302,2009,91,51,46,0,22,4,58,27,2,0,0,42,49,78,13,18,73
27Q302,2008,68,51,51,0,8,3,42,16,5,2,0,26,42,46,22,4,64
27Q302,2007,12,0,0,0,9,0,9,3,0,0,0,5,7,8,4,1,11
27Q308,2017,159,157,157,96,1,42,8,59,44,4,2,80,79,112,47,37,122
27Q308,2016,148,140,134,86,3,32,20,60,30,4,2,80,68,108,40,26,122
27Q308,2015,158,140,130,41,9,48,14,58,31,1,6,86,72,123,35,25,133
27Q308,2014,149,142,132,56,1,42,9,58,29,9,2,81,68,113,36,23,126
27Q308,2013,137,126,120,38,0,39,13,58,21,6,0,80,57,108,29,23,114
27Q308,2012,151,133,126,45,5,43,9,69,27,3,0,82,69,111,40,24,127
27Q308,2011,147,134,127,30,2,39,13,62,29,3,1,67,80,108,39,18,129
27Q308,2010,146,131,120,32,5,41,10,64,30,1,0,81,65,113,33,26,120
27Q308,2009,134,120,115,19,9,39,12,56,24,2,1,63,71,105,29,22,112
27Q308,2008,128,106,98,20,9,24,10,50,44,0,0,72,56,98,30,26,102
27Q309,2017,101,76,76,6,2,8,37,52,3,0,1,55,46,77,24,16,85
27Q309,2016,110,76,75,6,6,8,47,48,3,3,1,52,58,82,28,16,94
27Q309,2015,113,71,58,2,18,8,50,46,5,3,1,62,51,92,21,15,98
27Q309,2014,102,79,69,2,7,7,47,42,4,2,0,53,49,76,26,16,86
27Q309,2013,91,66,61,3,11,9,34,45,1,1,1,54,37,68,23,13,78
27Q309,2012,90,59,52,1,13,4,42,36,4,1,3,51,39,58,32,11,79
27Q309,2011,103,64,63,9,9,9,61,30,0,3,0,49,54,69,34,8,95
27Q309,2010,107,59,58,5,8,7,52,44,4,0,0,73,34,86,21,11,96
27Q309,2009,65,42,41,1,2,8,42,14,1,0,0,33,32,40,25,9,56
27Q309,2008,36,28,26,1,2,3,24,9,0,0,0,23,13,29,7,6,30
27Q314,2017,97,85,85,17,6,32,29,20,7,6,3,51,46,76,21,18,79
27Q314,2016,99,73,73,9,19,25,32,28,4,5,5,44,55,74,25,17,82
27Q314,2015,88,67,57,0,5,22,40,26,0,0,0,40,48,59,29,18,70
27Q314,2014,73,44,40,2,13,22,23,18,3,6,1,35,38,49,24,6,67
27Q323,2017,179,179,179,153,0,18,33,37,90,0,1,113,66,84,95,28,151
27Q323,2016,184,180,177,163,3,29,38,40,76,0,1,103,81,93,91,23,161
27Q323,2015,157,157,153,136,0,27,37,33,59,1,0,85,72,83,74,20,137
27Q323,2014,148,148,148,142,0,34,29,36,49,0,0,82,66,90,58,7,141
27Q323,2013,121,121,121,121,0,26,29,20,44,2,0,75,46,61,60,0,121
27Q323,2012,112,112,112,109,0,21,31,16,42,2,0,65,47,65,47,0,112
27Q323,2011,118,117,117,114,1,24,20,30,41,3,0,70,48,65,53,0,118
27Q323,2010,106,106,106,104,0,25,15,16,47,1,2,59,47,66,40,0,106
27Q323,2009,96,96,96,93,0,17,17,16,45,1,0,53,43,63,33,1,95
27Q323,2008,88,87,87,78,0,16,23,11,38,0,0,52,36,48,40,0,88
27Q323,2007,100,100,100,99,0,17,29,9,44,1,0,61,39,62,38,1,99
27Q324,2017,64,42,42,18,6,1,31,24,5,1,2,32,32,57,7,15,49
27Q324,2016,70,43,43,1,8,5,37,37,7,0,9,31,39,59,11,20,50
27Q324,2015,95,65,48,2,18,7,36,28,13,1,2,41,54,83,12,26,69
27Q324,2014,87,65,49,2,13,2,28,24,9,0,5,33,54,75,12,13,74
27Q324,2013,68,48,35,1,10,2,39,36,13,1,4,26,42,56,12,20,48
27Q324,2012,95,59,48,1,21,2,44,29,13,1,0,45,50,58,37,23,72
27Q324,2011,89,47,40,1,16,4,57,24,20,1,0,42,47,44,45,18,71
27Q324,2010,106,56,53,3,20,0,38,24,6,0,2,43,63,65,41,11,95
27Q334,2017,111,103,103,15,5,30,17,51,4,2,7,53,58,82,29,14,97
27Q334,2016,117,89,89,0,11,31,23,42,6,5,10,63,54,84,33,17,100
27Q334,2015,89,67,52,0,7,22,13,41,6,2,5,43,46,73,16,13,76
27Q334,2014,103,82,76,0,2,16,27,40,6,4,10,46,57,71,32,11,92
27Q351,2017,81,63,62,9,8,2,46,27,4,1,1,36,45,72,9,30,51
27Q351,2016,85,66,66,10,9,2,52,26,5,0,0,41,44,71,14,19,66
27Q351,2015,81,48,38,4,11,4,51,24,2,0,0,35,46,66,15,25,56
27Q351,2014,93,62,59,1,14,7,43,29,5,2,7,43,50,68,25,13,80
27Q351,2013,71,45,43,1,13,4,31,32,1,0,3,42,29,51,20,12,59
27Q351,2012,101,62,54,0,20,2,62,30,4,1,2,47,54,53,48,21,80
27Q351,2011,96,47,45,3,12,4,57,31,2,2,0,46,50,60,36,19,77
27Q400,2017,80,76,76,17,3,10,58,5,1,5,1,35,45,64,16,18,62
27Q400,2016,81,70,70,4,3,12,47,17,2,3,0,29,52,66,15,9,72
27Q400,2015,55,46,39,0,5,5,40,6,1,3,0,20,35,40,15,14,41
27Q400,2014,96,63,58,0,14,5,72,12,0,5,2,38,58,81,15,17,79
27Q400,2013,123,74,70,0,27,15,87,15,2,2,2,54,69,87,36,18,105
27Q400,2012,125,36,33,0,40,9,98,12,1,3,2,55,70,81,44,28,97
27Q400,2011,162,39,34,0,32,10,130,17,2,1,2,75,87,128,34,38,124
27Q400,2010,250,71,64,0,47,18,203,24,2,3,0,115,135,176,74,53,197
27Q400,2009,291,82,78,2,50,22,236,28,5,0,0,136,155,178,113,54,237
27Q400,2008,302,107,97,1,48,9,253,30,3,4,3,118,184,205,97,58,244
27Q400,2007,280,138,102,3,51,13,223,35,7,2,0,124,156,194,86,48,232
27Q400,2006,288,154,76,11,48,20,231,29,6,2,0,121,167,200,88,39,249
27Q400,2005,388,186,80,4,85,17,316,48,5,1,1,185,203,244,144,71,317
27Q400,2004,405,210,85,8,78,21,323,55,3,2,1,185,220,257,148,70,335
27Q400,2003,295,129,42,6,65,11,241,36,5,0,2,126,169,166,129,39,256
27Q400,2002,349,155,55,9,68,15,283,41,6,4,0,156,193,216,133,44,305
27Q400,2001,317,131,8,0,34,12,271,21,12,1,0,132,185,77,240,46,271
27Q410,2010,43,28,15,0,14,5,111,96,18,3,0,22,21,33,10,13,30
27Q410,2009,233,62,51,2,75,10,150,138,19,0,0,99,134,192,41,61,172
27Q410,2008,317,88,74,1,76,11,200,135,27,1,0,129,188,317,0,63,254
27Q410,2007,374,149,112,10,72,11,206,122,44,6,0,162,212,366,8,61,313
27Q410,2006,389,189,118,8,61,18,225,119,59,5,1,174,215,379,10,69,320
27Q410,2005,427,193,152,6,83,13,210,136,62,3,0,178,249,423,4,76,351
27Q410,2004,424,204,160,20,93,20,312,162,75,2,0,177,247,424,0,85,339
27Q410,2003,571,268,60,5,134,22,287,138,82,3,0,276,295,569,2,86,485
27Q410,2002,532,281,37,10,77,21,260,132,93,0,0,263,269,525,7,43,489
27Q410,2001,506,237,120,38,37,0,19,23,1,0,0,244,262,491,15,86,420
27Q465,2007,91,50,34,3,25,2,50,38,1,0,0,56,35,76,15,17,74
27Q465,2006,164,66,25,0,59,7,81,75,1,0,0,84,80,143,21,30,134
27Q465,2005,232,98,28,1,55,12,142,74,3,0,1,124,108,208,24,52,180
27Q465,2004,209,80,29,3,56,6,132,68,3,0,0,104,105,175,34,40,169
27Q465,2003,277,107,44,6,73,12,187,71,7,0,0,137,140,213,64,48,229
27Q465,2002,259,103,37,4,69,8,180,67,4,0,0,126,133,134,125,26,233
27Q465,2001,309,119,18,11,75,15,206,82,5,1,0,146,163,178,131,65,244
27Q475,2017,447,329,329,90,97,146,53,190,26,30,2,199,248,301,146,52,395
27Q475,2016,438,294,293,69,78,154,55,183,16,27,3,178,260,322,116,47,391
27Q475,2015,465,285,254,17,103,165,57,198,19,24,2,181,284,367,98,67,398
27Q475,2014,526,354,325,10,86,165,61,270,21,9,0,225,301,423,103,71,455
27Q475,2013,504,340,317,20,80,176,56,236,31,5,0,198,306,411,93,67,437
27Q475,2012,563,333,315,6,102,207,78,240,35,3,0,235,328,457,106,90,473
27Q475,2011,566,294,278,12,109,180,83,260,35,7,1,259,307,449,117,82,484
27Q475,2010,581,282,263,14,124,179,105,271,17,9,0,270,311,453,128,96,485
27Q475,2009,692,348,334,27,108,251,112,304,19,5,1,329,363,526,166,86,606
27Q475,2008,809,420,404,51,157,283,121,372,29,3,1,375,434,504,305,97,712
27Q475,2007,841,412,358,45,162,284,118,415,22,0,2,413,428,494,347,97,744
27Q475,2006,867,451,353,55,172,328,118,391,27,0,3,437,430,530,337,94,773
27Q475,2005,941,427,236,37,200,281,131,476,35,0,18,455,486,930,11,118,823
27Q475,2004,787,324,169,35,166,254,125,361,34,1,12,365,422,778,9,96,691
27Q475,2003,758,349,175,45,124,266,85,342,51,2,12,374,384,688,70,68,690
27Q475,2002,692,310,170,27,117,277,74,308,32,1,0,354,338,306,386,67,625
27Q475,2001,713,302,163,31,138,263,94,301,53,2,0,330,383,212,501,96,617
27Q480,2017,659,544,544,279,87,286,154,192,19,4,4,273,386,531,128,80,579
27Q480,2016,653,522,514,165,82,261,151,208,23,7,3,289,364,517,136,97,556
27Q480,2015,555,440,416,43,71,211,114,181,18,29,2,239,316,387,168,77,478
27Q480,2014,531,373,331,36,73,206,108,169,18,26,4,225,306,393,138,86,445
27Q480,2013,592,396,366,59,72,208,130,210,21,15,8,262,330,486,106,77,515
27Q480,2012,725,448,412,70,113,246,148,293,24,13,1,323,402,565,160,119,606
27Q480,2011,783,463,437,47,123,267,178,298,20,16,4,365,418,686,97,100,683
27Q480,2010,813,418,391,33,156,197,227,310,31,47,1,369,444,669,144,106,707
27Q480,2009,973,442,418,38,192,283,285,309,41,53,2,435,538,789,184,104,869
27Q480,2008,1002,489,459,45,160,285,261,380,33,40,3,457,545,812,190,123,879
27Q480,2007,984,564,443,52,146,282,271,372,46,10,3,467,517,783,201,107,877
27Q480,2006,808,460,344,36,142,248,203,291,43,3,20,387,421,617,191,98,710
27Q480,2005,799,374,245,33,135,201,238,282,48,8,22,360,439,588,211,114,685
27Q480,2004,812,330,223,37,146,221,224,252,67,6,42,380,432,584,228,114,698
27Q480,2003,792,345,217,57,147,249,190,243,72,9,29,375,417,445,347,70,722
27Q480,2002,781,352,218,54,126,271,191,243,64,7,5,383,398,453,328,45,736
27Q480,2001,733,304,129,6,113,236,189,232,73,3,0,350,383,382,351,80,653
27Q650,2017,257,252,250,225,0,88,27,86,31,16,9,84,173,183,74,50,207
27Q650,2016,259,255,246,183,1,76,27,96,26,7,27,87,172,190,69,39,220
27Q650,2015,237,233,219,112,2,67,19,88,31,3,29,80,157,167,70,32,205
27Q650,2014,255,244,233,119,4,88,28,71,36,7,25,84,171,162,93,33,222
27Q650,2013,231,226,215,123,1,83,20,83,28,2,15,84,147,153,78,24,207
27Q650,2012,236,223,219,85,2,92,27,82,33,0,2,57,179,164,72,29,207
27Q650,2011,233,220,216,93,6,73,34,99,22,5,0,69,164,152,81,21,212
27Q650,2010,236,223,222,54,0,82,20,104,25,4,1,68,168,160,76,16,220
27Q650,2009,224,218,215,85,1,62,26,85,50,1,0,83,141,125,99,9,215
27Q650,2008,218,208,205,49,6,66,21,88,43,0,0,80,138,165,53,9,209
27Q650,2007,195,190,182,49,1,58,16,83,37,0,1,79,116,135,60,8,187
27Q650,2006,177,156,146,27,2,49,27,79,18,0,4,43,134,131,46,12,165
28Q167,2017,102,101,100,65,0,18,20,36,16,10,2,54,48,66,36,21,81
28Q167,2016,104,102,90,47,0,13,17,50,17,3,4,53,51,70,34,27,77
28Q167,2015,108,102,97,26,2,26,22,45,12,2,1,58,50,76,32,18,90
28Q167,2014,110,104,88,14,0,16,26,33,27,3,5,52,58,70,40,22,88
28Q167,2013,100,97,92,35,3,8,12,43,35,0,2,43,57,54,46,19,81
28Q167,2012,114,114,111,12,0,22,16,44,27,1,4,55,59,58,56,16,98
28Q284,2017,92,91,91,66,0,20,40,12,2,13,5,55,37,72,20,4,88
28Q284,2016,84,81,79,41,0,22,49,10,0,0,3,56,28,51,33,5,79
28Q284,2015,88,85,83,35,0,33,47,2,2,2,2,52,36,64,24,7,81
28Q284,2014,84,80,79,46,1,28,39,8,3,3,3,47,37,54,30,6,78
28Q284,2013,81,79,77,44,0,30,35,14,1,1,0,40,41,51,30,4,77
28Q284,2012,80,75,75,39,1,16,59,5,0,0,0,38,42,55,25,4,76
28Q284,2011,70,65,65,39,1,17,47,6,0,0,0,39,31,50,20,3,67
28Q284,2010,70,63,63,32,2,15,48,4,1,2,0,37,33,51,19,0,70
28Q284,2009,72,62,62,23,0,7,55,10,0,0,0,37,35,53,19,1,71
28Q310,2017,112,100,100,42,5,41,35,16,6,8,6,58,54,93,19,10,102
28Q310,2016,106,82,82,19,5,26,51,23,0,4,2,51,55,100,6,11,95
28Q310,2015,108,74,67,13,2,40,43,15,4,6,0,51,57,89,19,20,88
28Q310,2014,112,91,88,18,2,34,59,13,4,2,0,61,51,95,17,11,101
28Q310,2013,100,88,83,19,4,28,53,13,5,1,0,51,49,79,21,16,84
28Q310,2012,93,70,68,9,6,16,57,17,2,1,0,48,45,71,22,8,85
28Q310,2011,103,75,74,16,3,31,50,16,5,0,1,56,47,83,20,10,93
28Q310,2010,105,82,77,10,2,26,48,26,5,0,0,57,48,96,9,17,88
28Q310,2009,103,81,78,17,2,36,52,13,2,0,0,52,51,76,27,6,97
28Q310,2008,75,60,60,12,4,28,33,12,2,0,0,29,46,59,16,13,62
28Q325,2017,105,100,100,22,0,19,53,27,2,2,2,61,44,75,30,23,82
28Q325,2016,110,95,95,11,0,29,38,33,0,6,4,62,48,75,35,19,91
28Q325,2015,111,99,89,8,1,25,45,32,4,4,1,54,57,77,34,17,94
28Q325,2014,112,99,92,9,6,36,41,25,0,7,3,66,46,91,21,21,91
28Q325,2013,102,86,81,11,3,23,45,23,6,3,2,56,46,82,20,10,92
28Q325,2012,121,95,90,8,3,30,46,31,2,6,6,69,52,83,38,14,107
28Q325,2011,100,76,75,10,4,37,35,23,5,0,0,56,44,78,22,9,91
28Q325,2010,91,67,65,3,4,27,39,14,7,3,1,45,46,63,28,8,83
28Q328,2017,126,121,121,58,3,29,43,42,6,1,5,58,68,85,41,22,104
28Q328,2016,103,98,97,30,2,25,41,25,4,6,2,41,62,74,29,12,91
28Q328,2015,116,106,106,23,1,31,35,32,4,9,5,60,56,92,24,14,102
28Q328,2014,120,112,112,26,2,27,48,23,10,6,6,67,53,96,24,24,96
28Q328,2013,96,87,87,28,5,22,38,28,6,1,1,52,44,87,9,21,75
28Q328,2012,106,88,88,20,5,26,51,26,1,0,2,44,62,91,15,17,89
28Q328,2011,87,69,69,11,7,20,38,25,3,0,1,36,51,68,19,8,79
28Q328,2010,72,60,60,15,3,17,34,19,1,1,0,40,32,60,12,12,60
28Q338,2017,57,6,6,0,8,6,29,14,3,4,1,20,37,38,19,7,50
28Q338,2016,132,20,18,0,11,23,63,39,5,2,0,53,79,106,26,10,122
28Q338,2015,91,13,13,0,17,7,45,32,2,5,0,43,48,79,12,13,78
28Q338,2014,107,12,11,0,17,16,49,23,8,11,0,51,56,94,13,13,94
28Q338,2013,69,1,1,0,17,4,32,20,4,9,0,29,40,55,14,10,59
28Q338,2012,94,2,2,0,29,10,41,26,8,9,0,56,38,78,16,10,84
28Q338,2011,88,2,2,0,42,3,43,32,4,6,0,44,44,75,13,13,75
28Q338,2010,100,3,2,0,37,7,33,21,28,11,0,47,53,87,13,10,90
28Q338,2009,102,6,5,0,40,3,32,17,38,11,1,58,44,77,25,3,99
28Q338,2008,101,5,4,0,37,3,57,18,12,11,0,57,44,87,14,5,96
28Q338,2007,104,3,2,0,30,1,63,24,2,14,0,63,41,81,23,5,99
28Q350,2017,122,114,113,50,5,38,40,18,7,7,12,62,60,86,36,14,108
28Q350,2016,124,108,105,58,10,48,32,26,6,4,8,71,53,89,35,15,109
28Q350,2015,126,113,108,55,8,51,49,17,2,4,3,71,55,82,44,12,114
28Q350,2014,132,109,102,56,9,64,53,6,1,3,5,72,60,98,34,18,114
28Q350,2013,145,120,116,33,7,61,62,13,6,3,0,80,65,113,32,16,129
28Q350,2012,123,109,104,48,8,42,65,11,1,3,1,55,68,90,33,12,111
28Q350,2011,131,117,116,45,3,58,54,17,1,1,0,69,62,105,26,10,121
28Q350,2010,23,18,18,1,2,3,12,6,2,0,0,16,7,19,4,0,23
28Q350,2009,40,37,37,20,0,18,16,5,1,0,0,20,20,34,6,0,40
28Q350,2008,40,34,34,14,0,27,12,1,0,0,0,16,24,33,7,1,39
28Q440,2017,891,774,774,422,15,201,74,302,268,10,36,457,434,630,261,128,763
28Q440,2016,897,793,785,415,26,209,77,289,287,6,29,469,428,680,217,145,752
28Q440,2015,1013,827,788,410,9,253,84,343,295,8,30,519,494,793,220,135,878
28Q440,2014,1043,905,859,447,18,273,96,358,290,8,18,557,486,793,250,118,925
28Q440,2013,910,750,714,310,15,227,76,298,270,12,27,441,469,597,313,112,798
28Q440,2012,942,790,766,330,32,244,99,300,286,6,7,488,454,575,367,108,834
28Q440,2011,967,822,796,382,42,240,94,344,282,6,1,525,442,604,363,118,849
28Q440,2010,929,752,726,368,51,271,78,255,322,2,1,485,444,597,332,95,834
28Q440,2009,1101,912,887,407,57,303,91,293,408,6,0,574,527,680,421,100,1001
28Q440,2008,987,820,786,324,51,264,94,296,326,7,0,488,499,536,451,98,889
28Q440,2007,1027,840,765,334,64,249,98,313,361,5,1,503,524,459,568,86,941
28Q440,2006,959,811,632,212,24,204,85,276,390,3,1,442,517,438,521,70,889
28Q440,2005,946,758,566,266,60,254,94,242,351,5,0,468,478,340,606,71,875
28Q440,2004,951,708,550,245,70,227,93,278,347,5,1,491,460,187,764,72,879
28Q440,2003,901,656,516,214,86,214,105,208,370,3,1,437,464,262,639,58,843
28Q440,2002,1061,752,599,252,95,240,117,230,471,3,0,545,516,206,855,54,1007
28Q440,2001,976,718,497,252,94,229,91,186,466,4,0,504,472,298,678,103,873
28Q470,2010,48,19,16,1,24,17,15,15,0,1,0,22,26,28,20,7,41
28Q470,2009,218,86,84,4,63,78,91,46,2,0,1,73,145,156,62,28,190
28Q470,2008,258,73,64,0,80,64,112,76,3,0,3,113,145,155,103,45,213
28Q470,2007,374,169,138,23,88,104,198,67,3,1,1,173,201,207,167,37,337
28Q470,2006,394,190,150,22,74,92,222,74,4,0,2,204,190,208,186,41,353
28Q470,2005,462,222,165,37,82,102,283,76,0,1,0,231,231,155,307,47,415
28Q470,2004,523,206,162,27,108,127,288,100,4,1,3,256,267,122,401,53,470
28Q470,2003,584,269,209,65,117,131,332,103,11,2,5,285,299,156,428,56,528
28Q470,2002,583,243,176,39,135,122,334,103,20,4,0,254,329,143,440,43,540
28Q470,2001,524,201,126,39,153,109,311,76,22,6,0,230,294,101,423,60,464
28Q505,2017,786,611,611,324,103,256,195,275,28,31,1,381,405,621,165,91,695
28Q505,2016,822,605,601,208,111,274,220,268,29,30,1,402,420,681,141,91,731
28Q505,2015,798,593,566,101,83,238,223,267,36,32,2,433,365,665,133,77,721
28Q505,2014,838,566,541,139,78,244,245,277,35,37,0,426,412,703,135,94,744
28Q505,2013,848,588,569,145,76,291,239,251,35,25,7,450,398,653,195,91,757
28Q505,2012,777,518,506,89,64,289,231,213,31,10,3,424,353,592,185,66,711
28Q505,2011,765,524,506,107,63,305,236,191,24,4,5,398,367,607,158,81,684
28Q505,2010,796,538,514,121,95,326,268,160,29,3,10,441,355,621,175,66,730
28Q505,2009,762,514,498,88,86,296,259,191,12,2,2,402,360,604,158,63,699
28Q505,2008,826,570,542,76,90,290,341,170,18,5,2,458,368,643,183,78,748
28Q505,2007,908,621,494,73,106,295,367,214,23,6,3,505,403,659,249,61,847
28Q505,2006,766,490,307,61,95,218,377,149,16,5,1,457,309,560,206,80,686
28Q505,2005,869,541,322,55,113,230,413,199,25,2,0,517,352,612,257,75,794
28Q505,2004,767,437,233,43,103,192,391,161,22,1,0,411,356,268,499,84,683
28Q505,2003,756,430,220,30,114,204,358,166,26,2,0,461,295,263,493,69,687
28Q505,2002,831,481,281,43,140,206,433,161,28,3,0,512,319,245,586,57,774
28Q505,2001,726,393,224,46,139,181,356,154,31,4,0,435,291,267,459,48,678
28Q620,2017,558,504,504,416,2,286,87,120,21,35,9,197,361,441,117,69,489
28Q620,2016,501,463,463,361,2,217,103,125,22,29,5,181,320,392,109,65,436
28Q620,2015,517,473,457,232,11,249,95,120,27,23,3,185,332,403,114,51,466
28Q620,2014,491,443,432,184,11,229,94,119,18,31,0,166,325,378,113,52,439
28Q620,2013,499,431,426,161,10,237,118,100,28,15,1,178,321,401,98,53,446
28Q620,2012,512,461,448,209,7,256,99,125,20,12,0,200,312,382,130,52,460
28Q620,2011,508,436,430,230,10,283,99,100,15,11,0,174,334,416,92,54,454
28Q620,2010,541,457,444,175,18,281,126,109,17,8,0,213,328,420,121,58,483
28Q620,2009,574,467,447,206,24,287,148,117,16,6,0,203,371,442,132,82,492
28Q620,2008,539,453,436,171,19,264,128,128,18,1,0,177,362,381,158,51,488
28Q620,2007,622,523,504,199,26,288,146,159,26,3,0,188,434,381,241,60,562
28Q620,2006,819,695,639,156,44,341,241,190,44,3,0,266,553,403,416,55,764
28Q620,2005,624,553,524,199,22,242,177,169,34,2,0,225,399,196,428,28,596
28Q620,2004,490,396,339,276,27,182,150,109,47,2,0,166,324,152,338,35,455
28Q620,2003,518,438,411,188,24,214,159,108,35,2,0,203,315,187,331,12,506
28Q620,2002,513,444,390,134,19,187,153,113,60,0,0,157,356,144,369,29,484
28Q620,2001,542,438,380,99,33,179,203,111,47,2,0,154,388,138,404,52,490
28Q680,2017,92,90,84,65,1,44,21,8,2,8,9,55,37,47,45,10,82
28Q680,2016,92,89,87,58,3,39,20,13,8,9,3,50,42,54,38,11,81
28Q680,2015,96,91,89,60,4,39,33,11,6,7,0,55,41,50,46,8,88
28Q680,2014,100,96,94,64,1,47,34,12,5,2,0,59,41,60,40,10,90
28Q680,2013,109,105,105,69,1,46,46,10,4,1,2,67,42,71,38,7,102
28Q680,2012,124,117,115,70,1,51,49,20,3,0,1,82,42,73,51,9,115
28Q680,2011,133,127,127,79,1,57,49,24,3,0,0,85,48,94,39,0,133
28Q680,2010,122,116,116,67,0,32,64,23,3,0,0,78,44,90,32,0,122
28Q680,2009,128,122,122,70,0,28,76,22,2,0,0,91,37,89,39,0,128
28Q680,2008,103,95,95,59,0,37,49,14,3,0,0,64,39,57,46,0,103
28Q680,2007,98,94,93,72,0,43,30,23,1,1,0,59,39,67,31,0,98
28Q680,2006,117,109,108,74,0,35,64,13,5,0,0,80,37,68,49,0,117
28Q680,2005,111,105,102,79,2,45,58,7,1,0,0,73,38,50,61,1,110
28Q680,2004,90,82,81,65,2,31,38,18,2,0,1,59,31,52,38,0,90
28Q680,2003,92,80,80,57,2,29,46,15,2,0,0,62,30,52,40,0,92
28Q680,2002,75,66,45,43,0,15,50,7,3,0,0,50,25,42,33,0,75
28Q680,2001,97,90,87,67,1,28,49,14,6,0,0,68,29,48,49,0,97
28Q686,2017,250,212,212,143,8,29,5,101,114,0,1,112,138,147,103,49,201
28Q686,2016,288,259,259,184,1,27,11,141,105,3,1,143,145,166,122,49,239
28Q686,2015,255,229,216,75,4,26,11,101,114,1,2,132,123,153,102,33,222
28Q686,2014,262,235,230,82,6,30,10,117,104,0,1,119,143,162,100,32,230
28Q686,2013,234,187,179,63,12,22,7,120,78,6,1,111,123,145,89,39,195
28Q686,2012,292,264,246,58,6,35,15,137,97,2,6,147,145,177,115,39,253
28Q686,2011,256,233,226,52,11,31,9,108,100,5,3,122,134,135,121,35,221
28Q686,2010,359,316,306,81,20,42,19,133,150,2,13,182,177,197,162,52,307
28Q687,2017,129,128,128,127,0,101,5,2,10,1,10,61,68,72,57,0,129
28Q687,2016,113,113,113,111,0,91,7,6,2,0,7,51,62,72,41,0,113
28Q687,2015,110,109,109,102,0,90,0,5,11,1,3,43,67,61,49,0,110
28Q687,2014,111,108,108,104,0,92,8,6,5,0,0,47,64,68,43,0,111
28Q687,2013,116,116,116,72,0,83,8,14,9,1,1,52,64,72,44,0,116
28Q687,2012,105,103,103,97,1,74,5,19,6,1,0,52,53,67,38,0,105
28Q687,2011,97,95,95,93,0,78,9,5,5,0,0,48,49,67,30,1,96
28Q687,2010,100,100,100,94,0,79,8,4,8,1,0,44,56,59,41,0,100
28Q687,2009,98,96,96,91,0,69,13,11,5,0,0,37,61,47,51,0,98
28Q687,2008,115,113,113,102,0,83,14,10,8,0,0,50,65,64,51,2,113
28Q687,2007,87,84,84,81,0,58,10,7,12,0,0,48,39,87,0,0,87
28Q687,2006,107,102,102,101,0,62,19,10,16,0,0,57,50,107,0,0,107
28Q687,2005,92,86,86,82,1,58,13,7,14,0,0,50,42,92,0,0,92
28Q687,2004,87,79,79,74,0,58,16,8,5,0,0,42,45,40,47,1,86
28Q687,2003,99,95,94,89,0,54,23,12,9,1,0,48,51,40,59,0,99
28Q687,2002,90,80,79,58,0,39,24,14,13,0,0,41,49,20,70,0,90
28Q690,2017,90,73,73,21,3,14,52,17,4,2,1,48,42,63,27,17,73
28Q690,2016,79,67,67,17,4,8,41,28,0,2,0,42,37,57,22,14,65
28Q690,2015,109,82,73,5,7,11,69,22,1,3,3,52,57,71,38,17,92
28Q690,2014,130,97,84,9,7,13,78,31,4,3,1,61,69,91,39,21,109
28Q690,2013,112,88,77,7,5,17,72,18,0,1,4,53,59,74,38,19,93
28Q690,2012,122,98,91,10,3,14,78,25,3,2,0,64,58,79,43,24,98
28Q690,2011,135,100,92,10,8,13,94,23,2,3,0,63,72,94,41,30,105
28Q690,2010,88,64,60,4,4,9,62,14,2,1,0,41,47,62,26,18,70
28Q690,2009,124,82,77,2,5,8,98,16,2,0,0,57,67,108,16,20,104
28Q690,2008,132,84,79,1,12,8,104,19,0,1,0,70,62,94,38,16,116
28Q690,2007,129,99,71,4,9,11,107,10,0,1,0,72,57,90,39,13,116
28Q690,2006,126,96,70,3,10,5,99,18,3,1,0,62,64,84,42,15,111
28Q690,2005,104,77,62,7,2,4,73,19,7,0,1,52,52,65,39,7,97
28Q690,2004,128,83,53,8,7,6,99,22,0,1,0,70,58,59,69,18,110
28Q690,2003,177,109,66,5,16,6,147,21,2,1,0,99,78,79,98,11,166
28Q896,2017,66,60,60,53,0,23,23,8,6,3,3,66,0,47,19,9,57
28Q896,2016,71,69,67,35,1,16,41,9,0,1,4,71,0,47,24,12,59
28Q896,2015,76,74,70,26,0,24,41,5,3,1,2,76,0,53,23,13,63
28Q896,2014,74,68,66,16,1,24,33,10,3,1,3,74,0,50,24,11,63
28Q896,2013,84,80,75,17,0,19,46,12,1,0,6,84,0,57,27,14,70
28Q896,2012,64,62,57,11,1,23,23,16,1,0,1,64,0,46,18,13,51
28Q896,2011,73,63,60,11,2,13,38,21,0,1,0,73,0,52,21,10,63
28Q896,2010,67,57,55,20,3,8,44,12,3,0,0,67,0,29,38,9,58
28Q896,2009,48,38,38,7,2,6,33,7,2,0,0,48,0,48,0,1,47
28Q896,2008,53,51,51,22,0,9,36,7,0,1,0,53,0,53,0,2,51
28Q896,2007,57,51,46,12,1,8,40,9,0,0,0,57,0,56,1,5,52
29Q243,2017,110,92,92,0,11,12,77,12,2,4,3,72,38,94,16,9,101
29Q243,2016,125,114,113,0,5,8,90,24,2,1,0,88,37,117,8,10,115
29Q243,2015,100,88,85,0,4,9,71,8,5,6,1,76,24,96,4,11,89
29Q243,2014,114,98,98,0,5,10,85,12,3,4,0,73,41,98,16,11,103
29Q243,2013,80,70,69,0,3,5,66,8,1,0,0,49,31,73,7,11,69
29Q248,2017,76,64,64,27,7,1,79,6,1,1,1,32,44,60,16,15,61
29Q248,2016,89,75,75,2,10,3,83,7,1,1,3,42,47,74,15,11,78
29Q248,2015,98,75,67,0,9,2,101,11,2,1,4,45,53,78,20,17,81
29Q248,2014,121,79,76,0,15,6,93,9,1,0,4,57,64,92,29,21,100
29Q248,2013,113,76,68,0,8,8,89,11,1,0,7,59,54,79,34,18,95
29Q248,2012,116,82,82,0,9,5,102,12,1,2,0,51,65,90,26,14,102
29Q248,2011,122,92,89,0,4,4,96,8,1,0,0,51,71,96,26,14,108
29Q248,2010,109,67,65,5,6,5,81,2,2,1,0,52,57,81,28,18,91
29Q248,2009,91,54,50,4,7,1,91,10,0,2,0,36,55,53,38,9,82
29Q248,2008,104,60,57,9,10,4,79,9,1,1,0,43,61,70,34,16,88
29Q248,2007,94,60,51,18,4,4,83,7,1,0,0,43,51,54,40,15,79
29Q248,2006,95,68,52,7,10,4,79,7,1,0,1,56,39,67,28,9,86
29Q248,2005,92,74,69,7,3,0,64,9,1,1,1,46,46,48,44,8,84
29Q248,2004,7,0,0,0,2,0,6,1,0,0,0,2,5,2,5,1,6
29Q259,2017,73,70,70,24,0,7,60,2,0,2,2,32,41,53,20,13,60
29Q259,2016,61,54,54,30,0,5,55,0,1,0,0,36,25,42,19,7,54
29Q259,2015,75,57,54,5,2,4,65,4,2,0,0,38,37,54,21,7,68
29Q259,2014,92,57,47,3,0,2,80,7,2,1,0,42,50,76,16,16,76
29Q259,2013,89,44,39,8,1,1,81,5,1,1,0,41,48,68,21,12,77
29Q259,2012,84,60,54,10,4,4,73,4,2,0,1,35,49,67,17,12,72
29Q259,2011,87,61,57,1,2,4,80,3,0,0,0,42,45,63,24,11,76
29Q259,2010,61,47,43,5,2,6,59,2,1,0,0,31,30,41,20,8,53
29Q259,2009,68,44,42,5,0,2,63,1,0,0,0,25,43,51,17,7,61
29Q259,2008,66,48,46,2,1,1,58,5,0,0,0,23,43,44,22,7,59
29Q259,2007,60,43,33,3,5,4,49,3,0,1,0,32,28,29,31,8,52
29Q259,2006,64,52,43,0,6,0,58,2,1,0,0,40,24,34,30,4,60
29Q259,2005,57,42,38,0,5,0,56,3,1,0,0,24,33,30,27,5,52
29Q265,2017,96,75,75,25,5,6,68,9,4,0,9,44,52,74,22,12,84
29Q265,2016,129,115,106,31,4,2,115,6,1,2,3,52,77,92,37,20,109
29Q265,2015,124,101,97,6,8,2,108,8,4,1,1,61,63,102,22,16,108
29Q265,2014,126,106,101,13,6,5,101,11,1,3,5,60,66,85,41,9,117
29Q265,2013,125,99,87,14,6,3,112,7,2,0,1,62,63,101,24,22,103
29Q265,2012,134,102,91,20,9,6,111,11,1,1,4,70,64,94,40,27,107
29Q265,2011,106,74,68,12,8,3,93,9,0,1,0,47,59,86,20,21,85
29Q265,2010,114,92,86,18,6,3,94,17,0,0,0,48,66,86,28,13,101
29Q265,2009,101,83,72,13,6,4,92,5,0,0,0,51,50,81,20,15,86
29Q265,2008,91,69,62,5,7,2,80,5,1,2,1,35,56,64,27,18,73
29Q265,2007,114,78,65,9,17,5,101,8,0,0,0,49,65,62,52,21,93
29Q265,2006,91,55,44,11,2,2,76,8,0,0,5,48,43,69,22,15,76
29Q265,2005,97,69,68,6,3,2,79,7,0,2,7,58,39,79,18,7,90
29Q265,2004,93,67,30,0,1,2,80,8,1,0,2,48,45,76,17,11,82
29Q265,2003,6,0,0,0,1,1,5,0,0,0,0,5,1,5,1,0,6
29Q272,2017,99,78,78,57,6,4,66,20,2,4,3,51,48,71,28,13,86
29Q272,2016,126,95,95,51,7,6,100,12,3,1,4,64,62,106,20,24,102
29Q272,2015,100,67,64,1,4,4,86,8,0,2,0,52,48,78,22,16,84
29Q272,2014,143,100,99,11,8,10,111,17,1,4,0,75,68,112,31,19,124
29Q272,2013,132,102,102,17,5,11,109,10,1,0,1,61,71,102,30,17,115
29Q272,2012,131,110,109,25,1,14,97,15,1,0,4,74,57,96,35,15,116
29Q272,2011,137,95,94,22,8,17,99,15,5,1,0,81,56,111,26,14,123
29Q272,2010,112,89,88,16,5,8,84,17,3,0,0,61,51,88,24,7,105
29Q272,2009,95,74,69,4,4,5,78,12,0,0,0,45,50,56,39,10,85
29Q272,2008,110,74,74,9,6,6,85,17,1,1,0,52,58,71,39,11,99
29Q272,2007,111,81,77,12,9,12,80,15,2,2,0,64,47,65,46,20,91
29Q272,2006,103,81,76,21,3,7,80,15,1,0,0,56,47,76,27,12,91
29Q272,2005,79,54,48,17,0,7,56,13,3,0,0,44,35,48,31,0,79
29Q272,2004,65,42,30,7,7,7,50,8,0,0,0,31,34,30,35,10,55
29Q272,2003,97,54,40,8,10,4,80,11,0,0,2,42,55,56,41,5,92
29Q272,2002,39,28,24,6,1,7,24,6,2,0,0,22,17,26,13,1,38
29Q272,2001,21,21,21,3,0,1,18,2,0,0,0,11,10,18,3,0,21
29Q283,2017,92,78,77,16,1,1,80,8,1,2,0,40,52,58,34,12,80
29Q283,2016,93,75,75,20,0,1,88,3,0,1,0,53,40,61,32,16,77
29Q283,2015,97,83,75,13,4,3,90,4,0,0,0,62,35,67,30,15,82
29Q283,2014,112,97,93,23,4,2,103,5,1,1,0,67,45,89,23,12,100
29Q283,2013,87,76,73,20,1,4,67,7,4,2,3,50,37,68,19,7,80
29Q283,2012,93,74,68,20,2,9,73,7,2,2,0,53,40,75,18,18,75
29Q283,2011,81,60,57,7,0,1,66,12,1,0,1,41,40,59,22,18,63
29Q283,2010,79,61,58,21,4,2,62,13,2,0,0,50,29,62,17,14,65
29Q283,2009,56,37,37,4,6,4,44,7,1,0,0,35,21,35,21,2,54
29Q283,2008,45,36,34,1,5,2,36,7,0,0,0,25,20,34,11,3,42
29Q283,2007,55,34,25,0,7,3,43,7,2,0,0,40,15,31,24,3,52
29Q283,2006,36,28,12,0,5,1,27,6,2,0,0,19,17,19,17,3,33
29Q313,2017,106,96,96,1,5,19,61,13,0,12,1,37,69,85,21,13,93
29Q313,2016,79,66,59,0,6,13,41,17,4,3,1,18,61,67,12,18,61
29Q313,2015,90,76,61,11,3,12,56,16,1,4,1,29,61,80,10,20,70
29Q313,2014,99,80,77,0,5,13,73,11,2,0,0,48,51,90,9,14,85
29Q326,2017,94,80,80,0,4,10,70,11,2,1,0,51,43,77,17,11,83
29Q326,2016,72,61,61,0,1,14,47,7,1,1,2,38,34,57,15,12,60
29Q326,2015,96,77,59,0,2,9,77,6,0,1,3,40,56,64,32,15,81
29Q326,2014,80,63,52,0,3,12,58,5,2,3,0,47,33,63,17,17,63
29Q326,2013,99,82,64,1,4,9,72,13,1,4,0,54,45,71,28,19,80
29Q326,2012,101,69,60,1,2,5,84,9,0,3,0,58,43,80,21,20,81
29Q326,2011,81,58,55,3,3,7,66,6,1,0,1,35,46,65,16,11,70
29Q326,2010,69,50,46,1,2,2,62,4,1,0,0,30,39,49,20,10,59
29Q327,2017,52,45,45,22,1,1,46,1,0,0,4,0,52,24,28,12,40
29Q327,2016,55,46,46,13,0,2,48,3,1,1,3,0,55,34,21,12,43
29Q327,2015,58,51,37,1,1,0,52,1,0,0,2,0,58,31,27,17,41
29Q327,2014,55,50,42,1,1,0,47,3,2,2,1,0,55,29,26,13,42
29Q327,2013,54,50,46,10,1,0,50,2,0,0,2,0,54,39,15,13,41
29Q420,2003,97,38,4,1,42,6,288,26,3,0,0,121,163,60,263,14,270
29Q420,2002,284,105,18,1,79,0,1,0,0,0,0,134,189,0,1,31,292
29Q420,2001,323,105,25,0,95,0,1,0,0,0,0,0,1,0,1,1,0
29Q492,2017,109,69,69,35,9,20,75,10,1,3,0,41,68,82,27,9,100
29Q492,2016,118,80,80,14,14,20,85,11,2,0,0,43,75,93,25,11,107
29Q492,2015,111,80,71,1,9,9,82,16,1,3,0,41,70,78,33,13,98
29Q492,2014,108,73,66,5,5,13,71,14,1,4,5,41,67,82,26,16,92
29Q492,2013,98,66,54,5,4,5,75,10,1,3,4,42,56,84,14,14,84
29Q492,2012,112,76,72,5,8,10,84,10,4,3,1,47,65,87,25,11,101
29Q492,2011,90,58,54,0,7,4,75,9,1,1,0,43,47,76,14,6,84
29Q492,2010,92,59,59,10,4,4,77,10,1,0,0,36,56,73,19,11,81
29Q492,2009,111,72,71,10,3,3,102,5,1,0,0,46,65,83,28,8,103
29Q492,2008,105,78,76,5,5,10,81,13,0,1,0,40,65,68,37,7,98
29Q492,2007,125,88,76,24,13,10,100,14,0,1,0,56,69,72,53,8,117
29Q492,2006,108,73,57,22,10,9,84,12,0,1,2,35,73,66,42,6,102
29Q492,2005,105,61,42,14,12,13,87,4,0,1,0,42,63,54,51,10,95
29Q492,2004,113,82,63,11,8,13,89,8,1,1,1,45,68,54,59,7,106
29Q492,2003,100,64,47,3,4,14,78,8,0,0,0,37,63,50,50,7,93
29Q492,2002,121,86,62,5,9,19,88,11,3,0,0,56,65,55,66,7,114
29Q492,2001,113,79,60,0,4,8,92,10,3,0,0,62,51,35,78,5,108
29Q494,2012,47,37,34,5,7,4,33,10,0,0,0,23,24,29,18,8,39
29Q494,2011,72,46,42,2,6,3,62,7,0,0,0,36,36,48,24,15,57
29Q494,2010,78,36,35,2,14,2,65,11,0,0,0,38,40,47,31,12,66
29Q494,2009,72,32,32,2,9,2,65,2,2,0,1,36,36,44,28,11,61
29Q494,2008,121,52,46,2,11,4,104,12,0,0,1,64,57,78,43,15,106
29Q494,2007,120,62,51,8,11,5,102,11,1,1,0,70,50,75,45,16,104
29Q494,2006,125,72,61,12,13,9,101,12,1,2,0,63,62,77,48,16,109
29Q494,2005,109,78,70,17,10,5,87,15,1,0,1,68,41,55,54,16,93
29Q494,2004,68,45,34,8,8,4,56,5,2,0,1,47,21,18,50,4,64
29Q494,2003,93,61,48,0,14,6,76,9,1,0,1,50,43,32,61,4,89
29Q494,2002,103,55,43,0,19,3,90,8,2,0,0,65,38,11,92,3,100
29Q494,2001,88,55,41,3,16,3,76,5,4,0,0,62,26,21,67,2,86
29Q496,2012,40,27,24,1,8,3,32,3,2,0,0,11,29,33,7,6,34
29Q496,2011,64,34,32,3,8,4,52,5,0,3,0,21,43,48,16,13,51
29Q496,2010,53,15,12,2,9,1,48,3,0,1,0,17,36,34,19,13,40
29Q496,2009,92,30,22,0,17,8,76,4,2,1,1,33,59,69,23,22,70
29Q496,2008,100,42,40,1,6,5,89,4,0,2,0,20,80,48,52,16,84
29Q496,2007,119,57,43,6,16,4,101,9,3,2,0,45,74,64,55,16,103
29Q496,2006,116,52,33,4,22,6,101,6,1,2,0,29,87,67,49,26,90
29Q496,2005,107,56,35,5,9,3,88,15,0,0,1,47,60,49,58,18,89
29Q496,2004,91,55,27,1,7,5,79,6,0,1,0,37,54,36,55,8,83
29Q496,2003,102,43,27,4,15,3,84,8,2,0,5,39,63,23,79,5,97
29Q496,2002,99,43,38,1,9,2,88,6,1,2,0,37,62,19,80,9,90
29Q496,2001,104,43,40,1,20,3,88,9,4,0,0,43,61,23,81,10,94
29Q498,2017,91,81,81,2,7,6,71,11,0,3,0,43,48,69,22,13,78
29Q498,2016,96,78,78,5,10,4,74,13,3,1,1,49,47,81,15,12,84
29Q498,2015,121,98,81,1,9,9,89,17,4,2,0,79,42,107,14,17,104
29Q498,2014,115,89,72,1,6,4,96,12,0,3,0,68,47,100,15,19,96
29Q498,2013,122,81,68,7,6,6,101,10,2,3,0,63,59,99,23,25,97
29Q498,2012,124,99,90,2,7,8,99,15,2,0,0,85,39,94,30,14,110
29Q498,2011,123,87,81,9,8,7,101,14,1,0,0,68,55,91,32,18,105
29Q498,2010,85,60,54,4,2,7,71,6,0,1,0,52,33,57,28,12,73
29Q498,2009,83,58,54,3,5,3,102,1,0,1,0,43,40,60,23,16,67
29Q498,2008,103,73,73,3,8,2,85,5,1,1,0,63,40,61,42,7,96
29Q498,2007,107,77,69,4,11,4,92,10,1,0,0,60,47,70,37,15,92
29Q498,2006,94,72,61,5,6,1,62,7,2,1,0,48,46,70,24,9,85
29Q498,2005,107,82,65,6,4,2,88,5,2,0,0,58,49,77,30,3,104
29Q498,2004,73,53,45,7,6,2,89,7,2,1,0,36,37,50,23,3,70
29Q498,2003,97,61,52,3,11,3,66,5,2,0,0,53,44,59,38,6,91
29Q498,2002,101,59,39,0,11,0,79,3,1,0,0,62,39,53,48,5,96
29Q498,2001,76,31,16,2,12,0,98,4,1,0,0,41,35,26,50,7,69
30Q258,2017,110,104,104,61,1,18,10,65,9,0,8,25,85,77,33,18,92
30Q258,2016,104,94,94,26,3,14,5,65,16,0,4,36,68,82,22,20,84
30Q258,2015,109,96,96,20,3,21,8,59,16,3,2,25,84,82,27,22,87
30Q258,2014,109,96,93,10,2,26,12,52,18,0,1,29,80,81,28,17,92
30Q258,2013,101,90,84,20,1,23,11,37,16,1,13,17,84,73,28,15,86
30Q286,2017,77,77,77,68,0,24,9,33,10,1,0,77,0,67,10,12,65
30Q286,2016,74,74,74,57,0,29,8,27,9,1,0,74,0,63,11,11,63
30Q286,2015,74,73,70,20,0,27,2,27,18,0,0,74,0,62,12,4,70
30Q286,2014,79,77,73,30,0,30,3,28,18,0,0,79,0,63,16,7,72
30Q286,2013,81,77,74,23,1,31,2,36,12,0,0,81,0,66,15,10,71
30Q286,2012,76,73,71,21,0,31,2,26,17,0,0,76,0,61,15,6,70
30Q286,2011,74,71,71,18,0,32,6,22,14,0,0,74,0,60,14,5,69
30Q286,2010,78,71,70,1,0,33,3,27,15,0,0,78,0,55,23,7,71
30Q286,2009,82,77,77,16,0,35,3,37,7,0,0,82,0,71,11,2,80
30Q301,2017,144,144,144,131,0,7,11,91,27,1,7,69,75,96,48,25,119
30Q301,2016,132,130,128,78,0,8,16,71,28,0,9,65,67,79,53,26,106
30Q301,2015,139,135,132,61,0,11,19,73,27,1,8,71,68,67,72,29,110
30Q301,2014,140,138,135,61,1,7,20,70,31,2,10,82,58,68,72,29,111
30Q301,2013,121,119,115,24,0,7,26,61,25,1,1,50,71,72,49,24,97
30Q301,2012,129,125,123,25,1,9,16,82,22,0,0,67,62,89,40,19,110
30Q301,2011,100,98,90,20,0,7,13,56,22,2,0,43,57,72,28,18,82
30Q301,2010,96,91,85,19,2,2,22,53,19,0,0,45,51,61,35,20,76
30Q301,2009,90,87,79,9,1,6,21,48,14,1,0,41,49,58,32,13,77
30Q301,2008,104,100,91,12,0,7,24,53,20,0,0,53,51,76,28,12,92
30Q445,2017,567,464,464,328,32,177,37,273,72,4,4,249,318,473,94,79,488
30Q445,2016,610,505,501,258,44,157,36,320,91,4,2,265,345,504,106,69,541
30Q445,2015,632,447,409,50,57,180,35,298,108,4,7,291,341,514,118,82,550
30Q445,2014,644,441,405,88,68,190,42,302,97,6,7,293,351,537,107,92,552
30Q445,2013,629,448,417,92,73,177,50,294,103,4,1,292,337,490,139,77,552
30Q445,2012,643,434,409,100,77,198,23,306,109,6,1,293,350,505,138,93,550
30Q445,2011,620,418,405,79,61,174,37,291,113,4,1,267,353,438,182,68,552
30Q445,2010,776,496,475,96,97,220,55,379,118,4,0,334,442,531,245,85,691
30Q445,2009,782,450,434,134,108,224,49,376,131,2,0,408,374,516,266,82,700
30Q445,2008,749,453,419,100,94,207,66,368,103,5,0,352,397,465,284,103,646
30Q445,2007,748,399,354,112,156,222,49,350,124,1,2,339,409,723,25,75,673
30Q445,2006,810,449,371,135,110,221,66,382,139,0,2,368,442,783,27,81,729
30Q445,2005,824,433,362,132,129,222,78,388,129,0,7,377,447,768,56,86,738
30Q445,2004,795,390,289,97,152,219,88,373,110,2,3,360,435,225,570,87,708
30Q445,2003,844,424,353,137,171,255,79,366,140,1,3,392,452,310,534,73,771
30Q445,2002,885,414,299,102,179,258,67,413,147,0,0,426,459,266,619,61,824
30Q445,2001,866,421,287,118,164,267,73,377,146,3,0,415,451,232,634,122,744
30Q450,2017,499,412,412,282,21,82,37,340,32,2,6,250,249,438,61,83,416
30Q450,2016,577,468,468,164,32,89,66,371,37,2,12,324,253,478,99,87,490
30Q450,2015,549,408,388,65,43,83,66,358,35,3,4,273,276,460,89,96,453
30Q450,2014,394,291,280,43,43,79,45,220,38,6,6,192,202,310,84,61,333
30Q450,2013,397,241,237,42,39,65,53,241,31,3,4,190,207,299,98,62,335
30Q450,2012,468,283,264,21,66,93,53,274,39,1,8,226,242,380,88,79,389
30Q450,2011,632,392,376,43,71,97,62,395,74,1,3,322,310,513,119,109,523
30Q450,2010,811,456,445,65,65,123,90,491,106,1,0,412,399,624,187,102,709
30Q450,2009,878,474,456,86,71,123,95,544,112,3,1,411,467,689,189,92,786
30Q450,2008,759,388,377,48,114,103,92,456,106,2,0,372,387,519,240,98,661
30Q450,2007,831,511,473,81,86,138,95,478,117,3,0,417,414,558,273,102,729
30Q450,2006,718,420,374,111,92,130,107,386,95,0,0,347,371,506,212,94,624
30Q450,2005,849,463,420,111,104,134,130,490,95,0,0,385,464,603,246,114,735
30Q450,2004,833,436,379,104,107,144,106,469,114,0,0,402,431,587,246,114,719
30Q450,2003,819,418,365,98,143,173,121,380,145,0,0,410,409,505,314,78,741
30Q450,2002,940,412,375,92,200,159,129,518,134,0,0,453,487,575,365,73,867
30Q450,2001,887,413,353,86,130,148,137,451,151,0,0,460,427,500,387,102,785
30Q501,2017,208,204,204,180,0,23,32,81,61,2,9,145,63,76,132,40,168
30Q501,2016,186,181,181,152,0,19,27,67,69,1,3,125,61,71,115,29,157
30Q501,2015,185,166,157,99,3,18,28,65,70,1,3,130,55,81,104,34,151
30Q501,2014,222,214,207,122,0,28,35,75,80,2,2,152,70,88,134,19,203
30Q501,2013,235,216,211,107,2,25,25,98,85,0,2,160,75,94,141,21,214
30Q501,2012,172,166,164,85,1,21,29,50,69,0,3,115,57,71,101,5,167
30Q501,2011,172,163,163,99,0,10,27,49,83,2,1,129,43,53,119,3,169
30Q501,2010,168,160,160,89,0,12,36,35,85,0,0,120,48,58,110,7,161
30Q501,2009,226,202,202,80,0,18,37,67,103,1,0,148,78,100,126,8,218
30Q501,2008,174,166,166,67,0,23,26,56,67,2,0,122,52,55,119,3,171
30Q501,2007,138,123,118,42,0,15,36,39,48,0,0,100,38,60,78,6,132
30Q501,2006,171,162,152,74,3,17,33,51,69,1,0,120,51,54,117,8,163
30Q501,2005,162,156,145,61,0,13,38,48,63,0,0,104,58,66,96,3,159
30Q501,2004,116,113,109,47,0,8,21,28,58,1,0,82,34,33,83,4,112
30Q501,2003,131,122,108,47,1,8,39,24,59,1,0,85,46,40,91,4,127
30Q501,2002,118,106,96,41,1,6,21,27,63,1,0,87,31,29,89,2,116
30Q501,2001,157,133,113,0,2,10,35,39,73,0,0,115,42,55,102,3,154
30Q502,2017,243,205,204,107,1,47,25,156,14,1,0,65,178,202,41,48,195
30Q502,2016,244,192,192,93,15,45,33,149,16,0,1,56,188,178,66,49,195
30Q502,2015,231,168,162,26,16,58,25,122,19,5,2,38,193,177,54,38,193
30Q502,2014,254,179,167,16,13,49,30,140,33,2,0,53,201,202,52,50,204
30Q502,2013,198,159,148,29,14,44,25,107,19,3,0,49,149,149,49,34,164
30Q502,2012,212,150,140,15,24,40,35,122,14,1,0,55,157,156,56,34,178
30Q502,2011,232,170,158,15,20,38,32,133,27,2,0,70,162,173,59,39,193
30Q502,2010,231,145,140,14,18,35,52,126,17,1,0,74,157,179,52,34,197
30Q502,2009,211,133,128,18,15,28,28,130,24,1,0,48,163,165,46,28,183
30Q502,2008,216,149,143,25,16,37,38,120,21,0,0,70,146,159,57,39,177
30Q502,2007,248,170,155,20,15,35,41,140,32,0,0,80,168,205,43,48,200
30Q502,2006,267,180,144,35,33,39,42,149,36,0,1,90,177,212,55,44,223
30Q502,2005,231,131,111,20,44,31,37,129,31,3,0,81,150,160,71,27,204
30Q502,2004,232,156,142,49,34,47,30,123,29,2,1,119,113,159,73,13,219
30Q502,2003,243,164,145,32,21,40,63,113,25,2,0,101,142,162,81,24,219
30Q502,2002,8,0,0,0,2,1,2,5,0,0,0,2,6,5,3,0,8
30Q502,2001,8,0,0,0,0,1,1,6,0,0,0,2,6,5,3,1,7
30Q555,2017,217,138,138,39,7,54,0,148,9,6,0,98,119,199,18,1,216
30Q555,2016,252,186,182,66,8,82,1,148,19,2,0,126,126,230,22,2,250
30Q555,2015,288,184,176,55,44,79,3,185,18,3,0,118,170,253,35,3,285
30Q555,2014,266,172,166,50,30,82,4,162,18,0,0,128,138,242,24,3,263
30Q555,2013,270,197,191,57,26,89,3,154,23,1,0,116,154,248,22,1,269
30Q555,2012,246,183,180,40,36,93,5,136,11,1,0,112,134,218,28,4,242
30Q555,2011,274,195,193,54,41,125,8,123,18,0,0,126,148,246,28,1,273
30Q555,2010,250,153,153,50,30,123,10,112,4,1,0,127,123,227,23,4,246
30Q555,2009,282,183,183,70,34,155,22,97,8,0,0,130,152,257,25,0,282
30Q555,2008,255,162,162,49,35,113,14,123,5,0,0,114,141,204,51,0,255
30Q555,2007,247,173,157,41,21,97,19,126,5,0,0,113,134,201,46,0,247
30Q555,2006,214,142,123,36,31,70,9,124,11,0,0,101,113,169,45,0,214
30Q555,2005,232,140,120,41,20,78,11,129,14,0,0,104,128,194,38,0,232
30Q555,2004,234,131,120,49,22,102,6,116,10,0,0,122,112,185,49,0,234
30Q555,2003,194,82,74,25,29,48,3,125,18,0,0,95,99,131,63,0,194
30Q555,2002,258,131,123,41,41,65,10,149,33,1,0,147,111,190,68,0,258
30Q555,2001,244,126,97,30,50,69,7,136,32,0,0,128,116,172,72,1,243
30Q575,2017,293,288,288,225,0,72,7,99,115,0,0,175,118,203,90,16,277
30Q575,2016,291,283,283,236,1,73,16,102,100,0,0,180,111,194,97,10,281
30Q575,2015,216,207,203,118,2,71,8,68,67,0,2,121,95,138,78,15,201
30Q575,2014,240,233,229,146,0,53,16,77,93,0,1,145,95,172,68,20,220
30Q575,2013,254,234,232,140,3,90,22,76,65,0,1,150,104,193,61,14,240
30Q575,2012,213,190,187,61,5,62,22,77,50,0,2,120,93,154,59,21,192
30Q575,2011,177,156,154,61,4,50,10,64,53,0,0,102,75,123,54,14,163
30Q575,2010,156,136,132,48,4,39,11,60,46,0,0,91,65,108,48,11,145
30Q575,2009,179,165,163,65,3,42,11,60,66,0,0,100,79,117,62,12,167
30Q575,2008,159,138,135,68,5,59,12,48,40,0,0,84,75,102,57,15,144
30Q575,2007,155,131,128,63,1,61,13,42,39,0,0,85,70,85,70,11,144
30Q575,2006,155,125,117,71,3,39,14,57,45,0,0,104,51,99,56,17,138
30Q575,2005,118,91,89,43,2,38,14,39,27,0,0,65,53,59,59,8,110
30Q575,2004,140,120,120,73,2,51,14,36,39,0,0,75,65,68,72,2,138
30Q575,2003,143,124,114,40,8,41,12,39,45,0,6,83,60,74,69,0,143
30Q575,2002,123,103,99,49,1,26,10,42,45,0,0,79,44,63,60,3,120
30Q575,2001,114,101,95,49,1,42,10,30,32,0,0,73,41,59,55,2,112
30Q580,2017,116,113,113,81,1,55,9,23,25,0,4,68,48,60,56,11,105
30Q580,2016,80,77,77,48,0,34,2,21,21,1,1,48,32,40,40,7,73
30Q580,2015,55,54,54,41,0,26,1,10,17,1,0,33,22,17,38,1,54
30Q580,2014,76,75,75,56,0,31,0,10,30,0,5,42,34,35,41,2,74
30Q580,2013,87,87,87,61,0,34,1,21,31,0,0,56,31,43,44,2,85
30Q580,2012,78,78,78,42,0,37,4,16,19,1,1,43,35,44,34,0,78
30Q580,2011,68,68,68,37,0,20,3,19,26,0,0,38,30,32,36,0,68
30Q580,2010,62,61,61,45,0,27,1,16,18,0,0,28,34,28,34,0,62
30Q580,2009,53,52,52,21,0,12,2,15,23,1,0,29,24,23,30,0,53
30Q580,2008,59,55,55,8,0,15,2,20,22,0,0,36,23,34,25,0,59
30Q580,2007,64,63,63,13,0,12,5,21,26,0,0,42,22,64,0,0,64
30Q580,2006,72,71,69,37,1,11,5,23,33,0,0,41,31,72,0,0,72
30Q580,2005,65,64,62,23,0,13,14,20,18,0,0,31,34,65,0,0,65
30Q580,2004,56,54,52,26,0,12,18,9,17,0,0,38,18,24,32,2,54
30Q580,2003,51,47,43,12,0,14,14,11,12,0,0,34,17,30,21,1,50
30Q580,2002,51,48,40,4,0,19,6,13,12,1,0,29,22,22,29,0,51
31R028,2017,21,15,15,13,0,3,10,8,0,0,0,0,21,15,6,13,8
31R047,2017,126,126,126,77,0,25,10,31,56,2,2,71,55,56,70,14,112
31R047,2016,126,124,119,49,0,18,12,18,74,2,2,75,51,64,62,16,110
31R047,2015,105,105,103,43,0,12,5,20,67,1,0,73,32,44,61,10,95
31R047,2014,133,132,127,69,0,19,9,22,81,0,2,78,55,62,71,19,114
31R047,2013,127,126,119,57,0,19,18,19,66,1,4,68,59,57,70,18,109
31R047,2012,126,126,115,32,0,9,5,32,80,0,0,65,61,41,85,19,107
31R047,2011,120,115,107,20,2,14,14,24,68,0,0,72,48,59,61,17,103
31R047,2010,134,120,114,22,2,17,23,20,74,0,0,82,52,59,75,22,112
31R047,2009,120,115,110,19,3,11,8,21,79,1,0,70,50,37,83,9,111
31R047,2008,145,137,130,18,0,18,17,24,86,0,0,84,61,63,82,23,122
31R047,2007,102,96,89,15,1,16,15,25,44,2,0,61,41,51,51,12,90
31R047,2006,80,76,66,8,1,12,10,8,48,2,0,47,33,32,48,10,70
31R047,2005,93,88,77,18,0,13,16,11,53,0,0,54,39,30,63,10,83
31R064,2017,105,99,97,27,3,2,8,18,60,0,0,58,47,47,58,28,77
31R064,2016,88,83,83,15,0,4,8,14,58,0,5,50,38,49,39,22,66
31R064,2015,89,83,75,9,2,4,9,27,69,0,0,44,45,38,51,23,66
31R064,2014,109,101,91,16,4,5,14,14,69,0,2,68,41,56,53,22,87
31R064,2013,104,95,83,8,0,4,17,20,71,0,1,48,56,46,58,23,81
31R064,2012,113,102,91,12,3,1,22,14,68,4,2,60,53,56,57,24,89
31R064,2011,111,89,81,6,2,6,9,19,56,0,0,58,53,61,50,26,85
31R064,2010,90,80,71,5,1,6,7,13,57,0,0,47,43,51,39,20,70
31R064,2009,83,63,50,1,4,7,16,19,47,1,0,31,52,39,44,19,64
31R064,2008,90,72,57,3,3,0,8,30,64,0,3,44,46,46,44,22,68
31R080,2017,111,107,106,55,0,6,22,27,56,0,0,52,59,46,65,30,81
31R080,2016,110,99,95,32,2,9,36,20,44,0,1,49,61,59,51,39,71
31R080,2015,109,103,85,33,0,13,25,24,45,2,0,45,64,59,50,24,85
31R080,2014,110,103,85,20,1,8,26,20,53,1,2,51,59,65,45,28,82
31R080,2013,119,106,96,27,2,6,28,26,59,0,0,54,65,63,56,17,102
31R080,2012,109,98,89,18,0,4,22,27,56,0,0,46,63,43,66,23,86
31R080,2011,120,98,85,25,4,15,21,23,60,1,0,51,69,67,53,26,94
31R080,2010,101,91,84,25,1,4,22,20,55,0,0,53,48,50,51,17,84
31R080,2009,130,119,113,43,0,7,21,22,80,0,0,64,66,44,86,19,111
31R080,2008,130,116,109,39,2,10,19,19,82,0,0,68,62,40,90,21,109
31R080,2007,127,109,99,36,1,4,20,17,85,1,0,61,66,44,83,30,97
31R080,2006,113,100,93,54,3,8,15,19,71,0,0,54,59,38,75,16,97
31R080,2005,111,108,92,44,0,10,16,20,65,0,0,54,57,24,87,7,104
31R080,2004,102,95,87,55,1,6,11,19,65,1,0,52,50,23,79,9,93
31R080,2003,104,96,85,43,2,4,15,11,74,0,0,53,51,27,77,6,98
31R080,2002,100,96,78,34,1,10,9,10,70,1,0,62,38,11,89,5,95
31R080,2001,86,86,64,37,0,7,8,6,65,0,0,42,44,11,75,11,75
31R440,2017,755,643,643,359,35,98,64,190,398,1,4,374,381,466,289,172,583
31R440,2016,764,661,625,324,22,84,69,205,395,4,7,361,403,479,285,157,607
31R440,2015,704,572,501,184,33,55,67,199,375,2,6,337,367,454,250,141,563
31R440,2014,738,598,525,179,36,65,86,198,378,2,9,344,394,441,297,136,602
31R440,2013,683,537,477,134,33,41,84,193,358,3,4,327,356,383,300,133,550
31R440,2012,648,507,455,115,32,59,79,181,326,2,1,316,332,331,317,129,519
31R440,2011,690,525,483,117,47,59,77,180,373,0,1,336,354,401,289,128,562
31R440,2010,668,488,440,103,66,51,87,187,340,3,0,302,366,367,301,119,549
31R440,2009,649,449,417,102,57,41,81,157,368,2,0,316,333,321,328,113,536
31R440,2008,612,443,428,102,43,43,77,160,332,0,0,270,342,311,301,99,513
31R440,2007,578,418,357,68,56,41,78,132,326,1,0,261,317,273,305,103,475
31R440,2006,509,375,301,85,45,45,59,88,317,0,0,247,262,189,320,77,432
31R440,2005,544,359,270,80,52,32,100,115,293,2,2,273,271,249,295,104,440
31R440,2004,585,368,255,103,57,47,88,123,325,2,0,290,295,242,343,115,470
31R440,2003,552,329,217,94,55,51,104,102,291,4,0,283,269,205,347,95,457
31R440,2002,521,299,197,73,64,36,86,81,317,1,0,276,245,181,340,59,462
31R440,2001,468,257,152,69,46,46,94,69,259,0,0,222,246,136,332,68,400
31R445,2017,403,331,329,122,29,44,89,171,90,6,3,193,210,306,97,101,302
31R445,2016,446,330,320,131,34,29,98,197,112,5,5,220,226,338,108,109,337
31R445,2015,363,249,208,43,33,24,92,161,78,3,5,170,193,283,80,83,280
31R445,2014,403,277,249,61,37,34,98,170,96,2,3,195,208,307,96,95,308
31R445,2013,402,266,230,34,51,29,114,168,90,1,0,194,208,287,115,110,292
31R445,2012,397,231,203,42,61,27,113,179,78,0,0,197,200,286,111,98,299
31R445,2011,479,292,269,35,77,33,138,199,109,0,0,222,257,318,161,116,363
31R445,2010,535,339,314,40,74,49,147,192,145,1,1,221,314,309,226,121,414
31R445,2009,566,329,307,59,69,38,174,203,145,3,3,252,314,344,222,94,472
31R445,2008,524,317,294,55,92,30,159,202,131,1,1,239,285,321,203,109,415
31R445,2007,598,378,315,65,72,44,184,199,166,5,0,309,289,326,272,113,485
31R445,2006,519,330,248,68,55,41,136,182,159,1,0,252,267,285,234,95,424
31R445,2005,566,319,228,55,53,47,147,178,192,2,0,289,277,296,270,102,464
31R445,2004,542,341,242,89,47,45,153,162,181,1,0,274,268,266,276,82,460
31R445,2003,592,369,263,71,55,52,159,162,217,2,0,308,284,261,331,76,516
31R445,2002,597,340,243,77,84,37,134,167,257,2,0,290,307,207,390,44,553
31R445,2001,591,371,256,77,77,44,143,144,259,1,0,279,312,152,439,64,527
31R450,2017,656,449,447,275,49,47,234,259,99,4,13,350,306,498,158,116,540
31R450,2016,587,437,432,210,64,42,209,245,86,4,1,338,249,467,120,89,498
31R450,2015,655,506,445,130,59,45,242,247,105,6,10,378,277,514,141,113,542
31R450,2014,635,450,403,92,66,39,233,256,99,5,3,324,311,503,132,114,521
31R450,2013,606,433,398,96,75,46,212,216,126,3,3,298,308,446,160,98,508
31R450,2012,549,402,339,95,63,41,230,184,91,3,0,295,254,400,149,114,435
31R450,2011,577,436,362,85,62,46,208,204,114,5,0,307,270,443,134,92,485
31R450,2010,595,466,391,62,55,42,210,191,149,3,0,341,254,398,197,96,499
31R450,2009,605,465,415,129,73,55,217,180,151,2,0,318,287,409,196,64,541
31R450,2008,592,423,393,109,32,38,238,182,130,4,0,331,261,390,202,84,508
31R450,2007,691,475,438,104,50,54,262,214,155,6,0,379,312,409,282,98,593
31R450,2006,649,449,404,121,63,38,261,190,154,4,2,353,296,410,239,95,554
31R450,2005,680,481,423,140,55,53,214,193,220,0,0,361,319,295,385,102,578
31R450,2004,540,349,302,142,47,34,172,160,173,1,0,263,277,218,322,81,459
31R450,2003,634,439,383,137,57,48,204,146,234,2,0,335,299,309,325,83,551
31R450,2002,602,396,307,94,65,32,200,169,201,0,0,327,275,310,292,67,535
31R450,2001,524,361,281,107,52,31,169,116,205,3,0,262,262,232,292,83,441
31R455,2017,953,905,905,677,4,57,9,111,770,3,3,492,461,376,577,221,732
31R455,2016,965,925,921,564,10,61,22,112,767,1,2,489,476,347,618,165,800
31R455,2015,929,844,748,312,28,44,18,104,754,4,5,460,469,328,601,171,758
31R455,2014,1025,908,812,347,34,66,13,122,808,2,14,498,527,380,645,170,855
31R455,2013,1029,897,818,286,36,47,18,125,827,4,8,473,556,296,733,184,845
31R455,2012,974,838,767,281,34,46,25,120,772,4,7,456,518,266,708,133,841
31R455,2011,982,848,787,289,37,56,18,85,812,8,3,477,505,276,706,138,844
31R455,2010,975,815,765,284,58,39,15,94,821,3,3,510,465,256,719,125,850
31R455,2009,913,732,691,254,42,46,17,89,756,2,3,450,463,259,654,122,791
31R455,2008,1038,846,801,341,69,70,21,106,838,2,1,507,531,204,834,132,906
31R455,2007,1004,809,718,310,67,56,17,99,830,2,0,484,520,182,822,132,872
31R455,2006,1069,877,732,305,87,72,22,103,870,1,1,503,566,141,928,136,933
31R455,2005,921,758,615,289,60,47,11,74,788,0,1,482,439,77,844,102,819
31R455,2004,948,749,600,269,69,67,23,69,788,1,0,463,485,90,858,94,854
31R455,2003,980,749,597,210,78,68,32,88,786,5,1,486,494,128,852,81,899
31R455,2002,1021,798,616,258,67,78,32,77,832,2,0,503,518,80,941,56,965
31R455,2001,997,760,601,262,94,62,22,84,828,1,0,467,530,54,943,105,892
31R460,2017,808,701,701,415,27,120,75,206,399,3,5,393,415,476,332,162,646
31R460,2016,845,739,734,381,19,132,89,228,384,6,6,431,414,469,376,172,673
31R460,2015,774,670,602,243,24,122,75,205,363,6,3,403,371,470,304,153,621
31R460,2014,761,651,590,219,24,108,87,194,365,2,5,370,391,439,322,142,619
31R460,2013,850,714,658,229,34,118,92,220,412,1,7,411,439,479,371,167,683
31R460,2012,929,773,733,248,52,140,95,251,434,5,4,458,471,470,459,156,773
31R460,2011,776,594,555,213,57,104,88,217,366,1,0,367,409,426,350,147,629
31R460,2010,793,642,599,204,45,118,81,178,411,4,1,385,408,407,386,151,642
31R460,2009,802,623,589,209,53,140,87,163,408,3,1,411,391,421,381,131,671
31R460,2008,797,598,566,190,65,118,94,197,382,3,3,402,395,411,386,148,649
31R460,2007,761,603,530,186,51,119,82,175,382,2,1,392,369,373,388,109,652
31R460,2006,912,692,580,217,73,137,106,188,471,5,5,442,470,392,520,146,766
31R460,2005,865,605,443,166,51,123,121,179,436,3,3,407,458,332,533,145,720
31R460,2004,789,554,454,161,62,134,98,156,400,1,0,436,353,189,600,139,650
31R460,2003,732,537,374,114,58,91,86,125,430,0,0,368,364,165,567,109,623
31R460,2002,702,513,359,132,84,90,83,117,412,0,0,299,403,134,568,94,608
31R460,2001,585,439,311,132,47,99,63,77,344,2,0,280,305,68,517,79,506
31R470,2017,56,15,13,0,5,1,17,40,12,0,1,33,23,49,7,24,32
31R470,2016,69,13,10,0,5,1,14,41,13,0,3,39,30,58,11,18,51
31R470,2015,71,9,6,0,15,2,33,37,23,1,2,40,31,56,15,24,47
31R470,2014,81,16,11,0,14,1,20,30,17,0,4,48,33,62,19,22,59
31R470,2013,72,10,8,0,14,3,21,38,19,0,2,47,25,50,22,17,55
31R470,2012,98,20,12,0,11,1,24,27,25,2,1,47,51,67,31,33,65
31R470,2011,83,18,9,0,16,1,25,37,19,0,1,46,37,56,27,24,59
31R470,2010,72,17,7,0,20,2,17,33,16,0,1,38,34,53,19,26,46
31R470,2009,83,16,14,0,21,2,20,26,15,1,0,40,43,52,31,18,65
31R470,2008,80,19,15,0,24,1,30,28,22,0,0,40,40,49,31,14,66
31R470,2007,83,23,17,0,27,7,24,23,20,0,0,48,35,55,28,17,66
31R470,2006,52,18,8,0,11,0,17,28,9,0,2,33,19,29,23,4,48
31R470,2005,69,19,9,0,8,0,24,35,8,0,2,36,33,44,25,12,57
31R470,2004,52,14,5,0,4,0,21,36,23,1,0,31,21,26,26,7,45
31R470,2003,64,15,5,0,15,0,23,31,25,1,3,36,28,40,24,5,59
31R470,2002,81,14,3,0,10,0,15,15,22,0,0,39,42,40,41,9,72
31R470,2001,74,16,0,0,10,0,18,18,16,0,0,38,36,26,48,7,67
31R600,2017,198,154,154,69,6,8,54,99,36,0,1,44,154,144,54,61,137
31R600,2016,199,149,149,99,9,12,48,91,44,3,1,40,159,125,74,61,138
31R600,2015,143,105,92,36,8,4,46,68,25,0,0,28,115,93,50,43,100
31R600,2014,163,112,104,32,8,13,52,65,33,0,0,37,126,110,53,41,122
31R600,2013,156,117,106,41,7,10,40,74,31,1,0,41,115,98,58,40,116
31R600,2012,146,98,86,4,12,5,47,64,29,1,0,39,107,85,61,45,101
31R600,2011,106,63,53,3,16,8,38,39,21,0,0,33,73,71,35,30,76
31R600,2010,149,106,91,22,13,10,48,58,33,0,0,43,106,89,60,33,116
31R600,2009,173,98,87,16,14,6,83,49,34,1,0,56,117,109,64,38,135
31R600,2008,184,118,103,9,19,8,70,63,43,0,0,61,123,104,80,51,133
31R600,2007,168,101,86,15,15,10,71,49,36,1,1,39,129,103,65,45,123
31R600,2006,175,97,75,56,17,9,72,48,43,1,2,51,124,93,82,43,132
31R600,2005,164,100,65,44,11,8,74,47,34,0,1,53,111,92,72,41,123
31R600,2004,176,100,76,20,22,3,68,59,46,0,0,72,104,174,2,44,132
31R600,2003,143,99,64,38,9,4,57,41,39,2,0,59,84,137,6,28,115
31R600,2002,133,79,53,11,12,7,52,34,40,0,0,52,81,52,81,27,106
31R600,2001,129,73,46,10,15,5,53,38,33,0,0,44,85,58,71,40,89
31R605,2017,332,328,328,321,1,173,2,12,141,2,2,148,184,132,200,6,326
31R605,2016,342,340,340,333,0,183,0,9,148,2,0,151,191,151,191,5,337
31R605,2015,323,323,323,311,0,147,6,4,165,0,1,142,181,125,198,3,320
31R605,2014,313,312,312,298,0,141,1,15,155,1,0,142,171,121,192,3,310
31R605,2013,326,324,324,320,0,138,4,22,161,0,1,131,195,101,225,4,322
31R605,2012,310,309,309,304,0,118,7,16,167,1,1,134,176,103,207,3,307
31R605,2011,295,292,292,289,0,113,1,16,162,2,1,117,178,92,203,4,291
31R605,2010,293,292,292,287,0,77,1,16,198,1,0,141,152,85,208,3,290
31R605,2009,284,282,282,274,1,92,3,15,174,0,0,121,163,78,206,1,283
31R605,2008,225,225,225,217,0,69,7,12,136,1,0,95,130,60,165,2,223
31R605,2007,210,210,210,203,0,60,6,6,138,0,0,81,129,44,166,5,205
31R605,2006,288,287,287,276,0,71,5,17,195,0,0,114,174,45,243,2,286
31R605,2005,224,224,224,221,0,35,1,6,182,0,0,123,101,11,213,3,221
31R605,2004,192,192,192,189,0,22,2,9,159,0,0,92,100,17,175,1,191
31R605,2003,180,178,178,175,1,35,1,6,138,0,0,97,83,10,170,0,180
31R605,2002,186,183,183,181,2,21,3,8,154,0,0,100,86,6,180,0,186
31R605,2001,220,183,183,180,3,23,9,8,180,0,0,115,105,10,210,1,219
32K168,2017,60,56,56,14,2,1,27,27,2,0,3,23,37,51,9,9,51
32K168,2016,61,50,50,0,3,2,24,31,1,1,2,29,32,56,5,14,47
32K168,2015,65,52,48,8,4,5,32,25,2,0,1,23,42,59,6,11,54
32K168,2014,50,41,40,0,2,2,24,19,5,0,0,20,30,44,6,7,43
32K168,2013,66,58,54,5,1,2,35,27,1,1,0,27,39,56,10,10,56
32K168,2012,58,45,43,9,6,1,16,16,1,0,0,24,34,56,2,9,49
32K168,2011,34,25,23,3,2,0,36,20,0,2,0,15,19,31,3,5,29
32K403,2017,64,54,54,11,2,1,5,56,1,0,1,28,36,62,2,11,53
32K403,2016,67,56,55,4,8,2,16,47,2,0,0,35,32,61,6,13,54
32K403,2015,67,48,33,2,8,5,7,52,3,0,0,37,30,57,10,8,59
32K403,2014,93,70,44,1,11,1,20,71,1,0,0,37,56,87,6,25,68
32K403,2013,96,65,40,6,14,4,14,76,2,0,0,54,42,55,41,16,80
32K403,2012,80,56,43,6,16,3,16,61,0,0,0,33,47,52,28,22,58
32K403,2011,80,55,45,10,13,1,12,66,1,1,0,47,33,51,29,8,72
32K403,2010,81,46,35,6,12,2,21,69,1,0,0,37,44,58,23,17,64
32K403,2009,93,55,44,2,13,1,23,79,1,1,0,50,43,93,0,17,76
32K403,2008,105,57,54,5,15,1,18,80,0,0,0,43,62,104,1,19,86
32K403,2007,103,66,51,3,17,0,14,65,1,0,0,54,49,98,5,11,92
32K403,2006,99,66,45,3,10,0,31,72,0,0,0,55,44,88,11,7,92
32K403,2005,6,0,0,0,0,0,3,2,1,0,0,3,3,6,0,2,4
32K480,2003,6,2,1,0,4,8,75,250,3,2,0,3,3,3,3,2,4
32K480,2002,338,186,38,0,126,2,75,242,2,1,0,150,188,176,162,55,283
32K480,2001,322,77,15,0,86,0,1,5,0,0,0,133,189,169,153,102,220
32K545,2017,116,108,108,29,6,1,12,108,0,0,0,52,64,104,12,36,80
32K545,2016,127,111,111,4,7,1,5,111,1,1,0,73,54,104,23,23,104
32K545,2015,127,103,89,0,13,1,13,117,2,0,0,55,72,107,20,24,103
32K545,2014,130,106,95,0,8,1,11,134,1,1,0,59,71,113,17,24,106
32K545,2013,121,81,68,2,17,5,14,138,0,0,0,52,69,108,13,28,93
32K545,2012,121,85,72,4,9,1,20,145,1,2,0,54,67,112,9,27,94
32K545,2011,119,72,64,2,10,1,12,135,1,1,0,53,66,108,11,23,96
32K545,2010,133,78,71,9,13,2,25,124,1,0,1,58,75,121,12,18,115
32K545,2009,148,90,84,7,18,6,13,112,0,1,0,74,74,141,7,22,126
32K545,2008,157,99,95,21,22,0,11,102,2,0,1,78,79,149,8,10,147
32K545,2007,169,98,58,16,18,0,17,107,3,0,0,79,90,145,24,13,156
32K545,2006,161,101,48,6,6,0,11,115,1,0,0,88,73,143,18,21,140
32K545,2005,150,91,44,19,11,0,9,120,1,0,0,82,68,135,15,15,135
32K545,2004,153,89,30,10,15,0,14,105,0,2,0,81,72,132,21,23,130
32K545,2003,132,91,51,27,12,0,27,133,1,0,0,74,58,103,29,17,115
32K545,2002,151,99,36,5,11,0,20,125,6,0,0,97,54,71,80,12,139
32K545,2001,116,85,10,10,2,0,15,91,10,0,0,74,42,89,27,6,110
32K549,2017,78,59,59,12,3,1,14,61,1,1,0,33,45,60,18,13,65
32K549,2016,89,71,71,3,7,1,17,65,5,0,1,45,44,77,12,22,67
32K549,2015,103,64,43,2,9,1,18,81,2,0,1,50,53,87,16,23,80
32K549,2014,105,68,48,2,12,1,19,82,2,0,1,53,52,89,16,17,88
32K549,2013,104,65,53,1,8,1,16,80,2,1,0,50,54,55,49,20,84
32K549,2012,99,68,51,0,7,1,18,83,2,1,0,60,39,65,34,19,80
32K549,2011,100,64,54,0,12,1,50,64,1,0,0,53,47,65,35,17,83
32K549,2010,109,74,61,0,15,1,28,75,0,0,1,63,46,87,22,22,87
32K549,2009,105,50,47,1,17,2,36,79,1,0,1,49,56,105,0,18,87
32K549,2008,116,68,67,2,11,0,14,88,2,0,0,59,57,115,1,21,95
32K549,2007,103,69,62,4,14,0,23,75,1,0,0,54,49,98,5,14,89
32K549,2006,97,74,59,5,9,0,35,72,0,2,0,52,45,72,25,18,79
32K549,2005,102,66,35,3,17,0,23,78,1,1,0,53,49,80,22,13,89
32K549,2004,105,76,32,1,12,0,32,55,2,0,8,51,54,81,24,8,97
32K549,2003,119,78,25,0,12,0,26,76,0,0,0,70,49,99,20,20,99
32K552,2017,55,54,54,3,0,2,7,52,3,0,1,25,30,54,1,13,42
32K552,2016,40,37,36,2,3,1,21,51,1,0,1,20,20,38,2,9,31
32K552,2015,53,34,29,3,6,1,13,58,0,0,0,29,24,50,3,12,41
32K552,2014,65,49,40,3,8,2,25,59,1,1,0,25,40,61,4,10,55
32K552,2013,52,42,31,3,6,1,30,77,2,0,0,23,29,51,1,16,36
32K552,2012,75,51,44,3,11,1,40,76,1,0,0,38,37,70,5,18,57
32K552,2011,72,40,32,2,21,1,41,77,4,0,0,29,43,69,3,23,49
32K552,2010,88,38,35,4,17,2,49,64,0,0,0,42,46,87,1,22,66
32K552,2009,110,54,40,5,17,3,26,72,0,0,0,47,63,85,25,21,89
32K552,2008,118,57,55,1,16,1,38,67,1,0,1,59,59,98,20,23,95
32K552,2007,123,71,67,5,23,0,15,40,0,0,0,62,61,97,26,20,103
32K552,2006,115,55,41,1,10,0,6,34,0,0,0,65,50,91,24,20,95
32K552,2005,106,63,24,1,13,0,10,41,1,0,1,53,53,71,35,23,83
32K552,2004,101,60,27,2,6,0,11,41,0,0,0,54,47,58,43,14,87
32K552,2003,108,58,21,3,13,0,33,71,2,0,0,45,63,77,31,12,96
32K552,2002,6,0,0,0,2,0,2,4,0,0,0,3,3,1,5,1,5
32K554,2017,64,63,63,47,0,5,6,49,3,0,1,36,28,51,13,12,52
32K554,2016,62,62,62,41,0,5,8,43,6,0,0,33,29,54,8,7,55
32K554,2015,59,56,56,35,1,2,5,51,0,0,1,34,25,53,6,6,53
32K554,2014,62,62,60,32,0,7,4,49,2,0,0,34,28,55,7,6,56
32K554,2013,39,38,37,14,1,1,10,25,2,1,0,16,23,36,3,7,32
32K554,2012,37,37,37,10,0,1,7,32,0,0,0,11,26,36,1,4,33
32K554,2011,40,34,34,7,0,1,1,28,0,0,0,20,20,35,5,5,35
32K554,2010,30,29,29,4,0,2,8,28,0,0,0,18,12,28,2,3,27
32K554,2009,34,32,32,3,0,1,9,13,0,0,0,15,19,30,4,2,32
32K554,2008,38,37,37,10,0,0,5,32,0,0,0,19,19,36,2,1,37
32K554,2007,35,35,29,4,0,0,7,27,0,0,0,19,16,30,5,1,34
32K554,2006,43,36,23,5,2,0,6,29,0,0,0,19,24,39,4,2,41
32K554,2005,46,37,23,4,0,0,7,36,0,0,0,23,23,46,0,5,41
32K554,2004,23,19,9,0,1,0,11,35,0,0,0,12,11,21,2,3,20
32K554,2003,23,21,12,0,0,0,8,15,0,0,0,10,13,20,3,2,21
32K556,2017,70,59,59,34,2,1,10,46,0,0,2,29,41,65,5,15,55
32K556,2016,59,48,48,7,5,1,12,47,2,0,0,27,32,55,4,19,40
32K556,2015,62,42,22,0,5,1,12,60,0,0,0,29,33,58,4,20,42
32K556,2014,72,48,33,0,10,1,13,55,1,0,0,28,44,70,2,14,58
32K556,2013,73,54,36,0,9,1,17,77,0,0,0,29,44,69,4,23,50
32K556,2012,70,52,43,0,7,2,28,80,0,0,0,38,32,67,3,13,57
32K556,2011,95,58,52,1,13,1,19,90,0,0,0,49,46,88,7,17,78
32K556,2010,110,68,56,3,14,1,22,94,0,0,0,58,52,104,6,20,90
32K556,2009,110,67,57,2,8,2,15,86,0,0,0,43,67,103,7,19,91
32K556,2008,110,41,31,2,18,1,12,67,1,0,0,44,66,98,12,25,85
32K556,2007,138,66,44,4,16,2,23,83,0,0,0,66,72,127,11,24,114
32K556,2006,117,65,28,5,22,0,15,53,2,0,0,66,51,108,9,19,98
32K556,2005,103,65,28,1,6,0,10,61,1,0,0,63,40,90,13,12,91
32K556,2004,81,54,18,1,4,0,20,90,0,0,0,47,34,72,9,9,72
32K556,2003,108,72,11,1,8,0,19,117,1,1,0,61,47,92,16,12,96
32K556,2002,6,0,0,0,1,0,1,5,0,0,0,4,2,4,2,0,6
32K564,2017,53,10,10,0,8,1,33,60,4,0,0,34,19,45,8,18,35
32K564,2016,87,22,20,0,14,1,53,93,1,1,0,40,47,78,9,24,63
32K564,2015,86,14,6,0,17,1,58,67,2,0,0,37,49,76,10,25,61
32K564,2014,110,17,9,0,22,2,45,92,1,0,0,51,59,97,13,32,78
32K564,2013,86,20,11,0,17,1,54,58,0,0,0,44,42,68,18,21,65
32K564,2012,84,16,10,0,18,2,65,110,2,0,0,45,39,65,19,26,58
32K564,2011,98,9,9,0,28,0,11,41,0,1,0,48,50,69,29,9,89
32K564,2010,136,14,10,0,50,0,23,64,0,0,0,70,66,104,32,18,118
32K564,2009,125,12,8,0,33,0,27,59,0,0,0,75,50,125,0,18,107
32K564,2008,168,6,6,0,69,0,36,72,2,0,0,93,75,168,0,20,148
32K564,2007,149,6,3,0,61,0,29,57,0,0,0,83,66,146,3,15,134
32K564,2006,128,10,3,0,52,0,28,54,1,1,0,71,57,111,17,17,111
32K564,2005,140,5,3,0,49,0,47,88,1,0,0,61,79,137,3,21,119
32K564,2004,113,7,0,0,41,0,53,70,1,1,0,49,64,110,3,14,99
32K564,2003,129,4,0,0,31,0,53,110,3,2,0,64,65,126,3,15,114
32K564,2002,179,7,0,0,31,0,52,76,1,0,0,106,73,157,22,17,162
32K564,2001,159,10,0,0,13,0,56,101,2,0,0,90,69,128,31,11,148
